

For November 2021 album releases, visit this page

This page highlights all singles released in every genre of Christian music… Read More 11/1Kurtis Hoppie - "Rooftops"11/2Coop & Battz - "Soul Trap"
Georgia Costolo - "Psalm 73 (Acoustic Version)" feat. Tyler Costolo*
Zahna - "I'm Sorry"11/5Alvin Cedric - "Wanderer" feat. Apex Frazier*
Anh Thai - "Love That Never Ends" feat. Praise Lubangu*
Aryn Michelle - "Merry And So Bright"
Asha Elia - "Need You" feat. IMRSQD*
Ben Potter & Jared Grant - "Be Still (B-Side)"*
Billy Ballenger - "Mercy (Radio Version)"*
Blake Reynolds - "Champion"*
Branden Anderson - "God Did It Again (Tell Somebody)"*
Building 429 - "Breath of God (Speak Peace)"
Canon & Poetics - "Narcoleptik" feat. KMO Shamaal
Colorvault & Young Ocеans - "Carry Me Along"
Common Hymnal - "Emmaus Cypher" feat. Sеaux Chill, Vincent Charlow, Royce Lovett, Andrew Blooms, Dee Wilson, Phillip Joubert, Seb Camry & Sharon Irving*
Crowder & Passion - "O Holy Night (Radio Version)"
Daphne Richardson - "Eternal Eyes" feat. CalledOut Music
Daystar - "Praise Him" feat. Leeland*
DeMarcus Kelly - "What Shall I Fear"*
Eagle Brook Music - "Christmas to Me"*
Emmanuel Smith - "Courageous Love"*
Generación 12 & Maverick City Musica - "Tu Gloria" feat. Johan Manjarrés, Aaron Moses & Laila Olivera*
Hulvey, KB & Lecrae - "Can't Tell It All (Remix)"
ISLY - "Majesty"
Jasmin Patterson - "With Us (Emmanuel)"*
James Fortune - "Never Let Me Down"*
Jet Trouble - "It's Coming"*
JJ Heller - "Today"
Jon Guerra - "Teach Us That One Song (Live)"*
Jordan Feliz - "Jesus Is Coming Back" feat. Jonathan Traylor & Mandisa
Jordan St. Cyr - "Rejoice"
Journey Worship Co. - "Not My Own"
knwbdy - "whutchugot" feat. wins & Spencer Boliou
Konola - "Double Edge" feat. Zelijah Tishbite
Konola - "Lean Widdit" feat. Zelijah Tishbite
Laity - "Howling"
Lizzy Parra - "En Familia"*
Mac Powell - "Jesus Christ Is Born"
Manuel The Creator, Marizu & Limoblaze - "All That I Need"*
Many Cities - "Siempre"*
Many Cities - "Te Busco"*
Mike Teezy - "Bible Going Viral" feat. Caleb Gordon
Montell Fish - "Fall in Love with You."
Nu Tone - "Conflict" feat. Adameant*
Oba Reengy - "Jesus"
Red Letter Hymnal - "Endless Summer"*
River Valley Worship - "His Name Will Be"
Rolling Hills Worship - "Break Out (Studio Single)" feat. Jennifer Akers*
Samuel Day - "Warrior Spirit"*
Selah - "Glory Hallelujah (Glória Aleluia)"
Swaizy - "MAYDAY"
Tay Collier - "Deep End" feat. Mog Trey*
The War Within - "Become Everything I Hate"*
Throne Seekers - "Patek"*
Vertical Worship - "Blessed"
Vineyard Worship & Tina Colón Williams - "Angels We Have Heard On High"*
Xander Sallows & Nitro X - "NOT HERE FOR THAT"
Xay Hill - "Trap" feat. King Chai*
Zauntee - "BackFromTheDEAD"11/7Kushim - "Waves" feat. IMRSQD*11/9Mae Mae - "Squishy"*11/10Jacob Early - "Good Heart Bad"11/11Crafted Child - "Before The Throne"*11/12Aaron David - "Angels We Have Heard On High"*
Alyssa Jordan - "What A Wonderful World"*
Andy Mineo - "Not Gon' Do (Acoustic)" feat. Joseph Solomon
Antwoine Hill - "I'm Free" feat. Arize & Miles Minnick*
Bayside Worship - "You Are My Hope"*
Benjamin Hastings - "A Father's Blessing"
Brad & Rebekah - "See Your Faithfulness"
CCV Music - "Hark the Herald Angels Sing"*
Chad Bushnell - "Thank God"*
Christopher Syncere - "NINE 2 FIVE"
C3 NYC - "Simple Day"
Daniela Galeano & Townix - "Un Call"
Dubem - "Supreme (Remix)" feat. nobigdyl.
Eris Ford - "Keep Me"*
Grace Gaber - "Savior & King" feat. Lane Norberg*
Jamie Kimmett - "Angels We Have Heard on High"
Jay Violet & Battz - "I's On Him"*
Jes Norris - "on my knees (Remix)" feat. Roy Tosh
John Commons - "Good To Me"*
Jonathan Miller - "Glory Fall"*
Jon Keith - "Life Of The Party"
Jude Barclay - "act my age"
Justin Rizzo - "Paid It All (Live)"*
Justin Warren - "Back to Life"*
KXC & Rich & Lydia Dicas - "Unshakeable"*
Limoblaze & Johnny Drille - "This Loving"*
Marc Britt - "Conqueror"*
Matthew Mole - "ohmygosh"
Mike Edel & Tow'rs - "Have Yourself A Merry Little Christmas"*
nathan huang - "FORTRESS"*
Our Future Glory & S.O. - "Breathe Again" feat. The Found*
Red Tips - "Hedges and Highway"*
Rock City Worship - "Surely Now"*
Rockstar Jt - "334"
Ryan Ellis - "Heaven (Song Session)"
Ryan Stevenson - "Heart and Soul of Christmas"
Sam & Christin Hart - "There is Hope"*
SEU Worship - "We Say Yes" feat. Sydney James & Dylan Dames
Simple Hymns - "Trusting In Jesus (Anchor)" feat. Kurtis Parks & Jemia*
Skillet - "Standing in the Storm"
The War Within - "How You Love Me" feat. Madison Nightingale
The War Within - "How You Love Me (Acoustic Version)" feat. Madison Nightingale
Todd Dulaney - "Satisfied (Radio Edit)" feat. Smokie Norful*
Trampolines - "Passport"*
Wallace Grant II - "He Is" feat. Kefia Rollerson*
We Are Vessel - "Hope"*
Young Dumbs & J.Steph - "Take My Hand (Forever)"*
Young Saint - "God Is Good"*11/15Christ Encounter - "Bright and Morning Star"11/17Chandler Moore - "It's the Most Wonderful Time of the Year (Spotify Singles Holiday)"
Lecrae & 1K Phew - "WILDIN"
Poor Bishop Hooper - "Psalm 99"*
Wolves At The Gate - "Lowborn"11/19Abby Robertson - "Miracle of Christmas"*
Alvin Cedric - "Growing Up"*
Andrea Olsen - "The Proof"*
Angie Rose - "Es Navidad (O Holy Night)" feat. Ekos & Townix
Bayside Worship - "We Will Never Stop"*
Brady James - "Cash Clears"
Casting Crowns & Essential Worship - "Scars in Heaven (Song Session)"
Chris August - "This Christmas"
Christian Singleton & Moflo Music - "So Much More"*
Christopher Syncere - "AMEN"*
Cochren & Co. - "Christmas (What the World Needs)"
CRC Music - "Making Rivers"*
Dani Miché - "Let Love"
​​half•alive - "Hot Tea"
Hannah Kerr - "Forever Evergreen (Here in the Winter)"
He Is We - "Frankenstein"*
Isabel Davis - "We Lift Our Worship (Live)"*
Jamie Grace - "Show Love" feat. Morgan Harper Nichols*
JJ Hairston - "Thankful"*
Jonathan Allen Wright - "An Industry"*
Julie Susanne Clark - "After the Violence"*
KB - "So Tired" feat. Bizzle & Zhalarina
Kevin Quinn - "Over And Over Again"
Lilly Goodman - "Por Un Año Más"*
Martin Smith - "Fire in Your Eyes"
Meil San Marcos & Danny Gokey - "Dios Es Más Grande"
Mitch Darrell - "Klondlike" feat. Xay Hill, Red Tips & Raw-B*
Proud Refuge, Marizu & Limoblaze - "I Never Knew"*
Pyramid Park - "Peace. Calm. Breathe."
Red Tips - "Psalms 777"*
RIDERS - "Forever and Ever" feat. Circuit Rider Music & Eileen Walker
Sarah Nathalié - "I Choose You" feat. Noël Mio
Sarah Nathalié - "No Talk"
Skye Reedy - "Reconcile" feat. DOE*
Stephen McWhirter - "Born A King"*
Stephen Stanley - "Heavy"
The Afters - "I Will Fear No More (Live)"
TheEDGE - "Not Afraid" feat. Noah Walker*
THEM PARENTS - "Heart of Mine"
Wilder Adkins - "Mary's Lullaby"
Xander Sallows, Sam Bowman & Matias Ruiz - "Someone (Remix)"*
350, Wxlf & Coop - "College"*11/21Dunsin Oyekan - "One on One (Live)"*11/22Britt Nicole - "I'll Fight for You"
MARICLR - "Cover Me"*11/24Jimmy Cheo - "24/7 Heaven (Demo)"*11/25Soulsician - "Conversation"*11/26Andrew Word - "Holding Us All Together"*
Andy Cherry - "Your Presence is A Miracle (Live)"*
AO1 Collective - "Keep The Fire On" feat. Saint James & Marie Love*
Brooke Nicholls - "Saviour Of The World"*
CalledOut Music - "Oba Ti De (The King Has Come)"*
Civilized Creature - "Attuned" feat. Jaimie Poon*
Darla Baltazar - "Torn"*
Dawson Hollow - "O Come O Come Emmanuel"*
Drew Holcomb & Ellie Holcomb - "Hung the Moon"*
Eliza King - "All Things New (Reimagined)"*
Jaay Verano - "BBQ IN HEAVEN" feat. nobigdyl.*
Jonathan McReynolds - "The Greatest Adventure"*
JSteph - "My Destiny" feat. Leyn Colt*
Jude Barclay - "stupid behavior"
Kenny Hass - "Don't Go Away" feat. Mark Barlow
knwbdy - "bold" feat. wins
Lydia Laird - "Have Yourself A Merry Little Christmas"*
Madison Ryann Ward - "Love&Adoration"*
Miles Minnick - "God Put Me On"
Montell Fish - "Destroy Myself Just For You"
NK Maduforo - "Perfect; Just Not Together" feat. Angeloh*
Noël Mio & Moflo Music - "Safety" feat. Sarah Nathalié*
Planetshakers - "A Very Merry Christmas" feat. Mateus Asato & Jesus Molina*
Ramzi Nicholas - "Heal Me" feat. Skylah Dawn*
ROY3LS - "Without You."*
The Afters - "Well Done (Live)"*
WorshipMob - "Heaven Is Coming"*
Xander Sallows & Ben Lawrence - "wait another day."*
10DA & Paul the Messenger - "Feel It"*11/28John Carter - "Mountain of Spices" feat. Ben Potter*
Several Other Ghosts - "Here We Go Again"11/30Abe Parker - "Stupid Face"*
Uzuhan - "Tough 