

Heart starts to beat
Heart starts to beat

I always dream that I'm walking on water
Search for the sun as it cuts through the blue
I'm reaching out, I'll be on the horizon
Through your reflection my heart starts to beat
My heart starts to beat

Through your reflection my heart starts to beat
Heart starts to beat

Heart starts to beat
Heart starts to beatYou might also 

For April 2022 album releases, visit this page

This page highlights the notable singles released in all genres throughout April 2022. Each song… Read More 4/1
5 Seconds of Summer - "Take My Hand"
71 Digits & Flo Rida - "Low"
A Boogie wit da Hoodie - "Playa" ft. Ella Bands
Álex Ubago - "Cuanto antes" ft. Lali
Alexander 23 - "Crash"
Alfie Templeman - "Leaving Today"
Alok & Bastille - "Run Into Trouble"
A$AP ANT & A$AP Rocky - "The God Hour"
Avila Brothers - "A Hard Working Man" ft. Snoop Dogg & Billy Ray Cyrus
AWOLNATION - "Material Girl" ft. Taylor Hanson
Black Birdie - "get over it"
Blasterjaxx - "Hurricane" ft. Prezioso
Blu DeTiger - "Hot Crush Lover"
BONES & ghost/\/ghoul - "Silverado"
Caitlyn Smith - "Dreamin's Free"
Call Me Karizma - "Young, In Love & Depressed AF"
Chris Brown - "WE (Warm Embrace)"
CHRIST DILLINGER - "A Reflection"
City Girls & Fivio Foreign - "Top Notch"
Col3trane - "Logan Paul"
DaBoyDame & Rick Ross - "Feelings" ft. EST Gee
Dave East - "Game 6 (East Mix)"
Dreezy - "They Not Ready"
呂爵安 (Edan Lui) - "Elevator"
ELIO - "Vitamins"
EMELINE - "cinderella's dead"
Fred De Palma & Justin Quiles - "ROMANCE"
Freddie Gibbs - "Ice Cream" ft. Rick Ross
Foals - "Looking High"
G Perico & Dave East - "Half A Bird"
Gavin James - "Circles"
Geowulf - "Drown"
Gryffin & OneRepublic - "You Were Loved"
Gucci Mane - "Blood All On It" ft. Young Dolph & Key Glock
Hardwell - "Into the Unknown"
Harry Styles - "As It Was"
Hotboii - "All I Know"
Isaac Dunbar - "Tainted Love"
Jaycoma & WILLSØFR3$H - "12 AM (Remix)"
Jenn Morel - "Tempo"
Jewel - "Living With Your Memory"
Joyner Lucas - "Ye Not Crazy"
Jubël - "So Sick"
Keith Urban - "Nightfalls"
Kiiara - "Microdose"
La Duraca - "LA VIDA"
Leven Kali - "LET IT RAIN"
Lil Eazzyy - "Nothing Left"
Lil Tjay - "In My Head"
Liam Gallagher - "C'mon You Know"
Llane & Omar Montes - "Sueño"
Lucki - "MEET ME THERE"
Lupe Fiasco - "100 Chicagos"
Martin Garrix & MESTO - "Limitless"
Masked Wolf & Bring Me The Horizon - "Fallout"
Matisse - "Un Nuevo Amor"
Matoma & A R I Z O N A - "Heart So Big"
Nascar Aloe - "IPA"
Natanael Cano - "Estrellas"
Never Broke Again - "Pull Up Actin" ft. YoungBoy Never Broke Again & P Yungin
Nightly - "hate my favorite band"
NLE Choppa - "Yak Flow"
Olivia O'Brien - "Bitches These Days"
Onlybino! - "Wya Freestyle"
Peces Raros & Trueno - "Cicuta (Remix)"
PGF Nuk - "Waddup (Remix)" ft. Polo G
Phabo - "Before I Let Her Go"
​ppcocaine - "Homie Hopper"
Rae Morris - "Running Shoes"
Rahky - "Get Out"
Sarah Close - "Gettin Older"
Slatt Zy - "Feel It In My Soul"
Sofía Blumer - "Solita en la Playa"
SOFI TUKKER - "Kakee"
SOG, Ryan Castro & Totoy El Frío - "La Nueva" ft. Blessd, Nath & Natan & Shander
Steele 11 - "THROW UP!"
Tee Grizzley - "Buss It All Down"
Thomas Rhett & Katy Perry - "Where We Started"
Tory Lanez - "Florida Shit"
Unlike Pluto - "Shelf Life"
Wiplash - "Ana"
Wiz Khalifa - "Iced Out Necklace"
Young M.A - "Tip the Surgeon"
Kanon, DJ.Silence - "Mavro Poiniko"
4/2
Summrs - "​bird allegiance"
4/3
Apethantos, Thitis - "BERSERK"
John Legend - "FREE"
Masicka - "History"
4/4
August Alsina - "Shake The World"
AURORA - "The Woman I Am"
BANKS - "Meteorite"
Jan Curious - "早晨 (Good Morning)" ft. 葛民輝 (Eric Kot)
J Arias - "Si Supieras"
Lil Darkie - "RUN"
MKULTRA - "It's About Time"
Rose Gray - "Last Song"
Santa Fe Klan - "Mar y Tierra"
Triple G - "Wonder"
​​vf7 & Lyanno - "Ya No Es ="
Wet Leg - "Ur Mum"
4/5
10Tik & Skillibeng - "Activate"
Anna Calvi - "Ain't No Grave"
Asian Doll - "Fell In Love"
CXRPSE - "LEASH"
DESTIN CONRAD & Kiana Ledé - "Unpredictable"
Doodie Lo - "FACE"
衛蘭 (Janice Vidal) - "風靡 (In The Wind)"
Juliana & Humbe - "Muchachitos"
L-Gante & DT.Bilardo - "SUSY 420"
Lizzy McAlpine - "hate to be lame" ft. FINNEAS
Mandy Moore - "Little Dreams"
Martin Garrix & Vluarr - "Reboot"
ScHoolboy Q - "Soccer Dad"
Taylor Bennett - "Fall Short"
TOPS - "Perfected Steps"
XANMAN$HAWTY & Bleachdiego - "Picture Perfect"
Wallice - "90s American Superstar"
4/6
Acid Souljah - "Captain Beefheart"
BANKS - "Deadend"
BRUHMANEGOD - "​oxygen"
Danntik & Santa RM - "A Mí"
DDG - "Whiskey Freestyle"
El Alfa, French Montana & Braulio Fogon - "Máquina de Dinero" ft. Kaly Ocho
Jalle & Issey Cross - "Downers"
Kris Floyd - "Cuentas Claras"
Lele Pons & Kim Loaiza - "Piketona"
Lil Gotit - "She Know It"
Melody's Echo Chamber - "Alma"
Netta - נטע - "I Love My Nails"
陳蕾 (Panther Chan) - "世界與你無關 (Embrace Yourself)"
Paulo Londra - "Chance"
Pusha T - "Neck & Wrist" ft. JAY-Z & Pharrell Williams
Rei & Mesita - "RAM PAM PAM"
Rolling Blackouts Coastal Fever - "My Echo"
RUGGERO - "YA FUE"
Stunna 4 Vegas - "M & M" ft. Sneezo Quixk & Ola Runt
Suki Waterhouse - "Wild Side"
wifisfuneral - "Honeybunz"
Wiz Khalifa, Big K.R.I.T. & Girl Talk - "Ain't No Fun"
WOS - "ARRANCÁRMELO"
4/7
Alicia Keys - "City of Gods (Part II)"
Alison Wonderland - "Forever"
Blessd - "Instagram"
CB - "Rap or Road"
Cian Ducrot - "All For You"
CNCO - "La Equivocada"
D.OZi - "Javy Báez 'El Mago'"
DJ Nelson, Jay Wheeler & Sammy Baby - "Loco Por Verte" ft. Alejandro Armes
Ethel Cain - "Strangers"
FKJ & Santana - "Greener"
​gizmo - "Flesh Made of Flaws"
iamamiwhoami - "canyon" ft. Lars Winnerbäck
Interpol - "Toni"
Jotaerre, KAROL G & Alejo - "Un Viaje" ft. Moffa
Kevin Roldán & DEKKO - "Perreito Under"
Khalil? - "LO NE LY"
KYSLINGO - "Cold Turkey"
Lefty Sm - "Original"
Lime Cordiale - "Facts of Life"
LIT killah, De La Ghetto & L-Gante - "KU'"
Mariah Angeliq - "Hey Siri"
Miranda Lambert - "Actin' Up"
Nickoog Clk - "En el Jacuzzi"
Nico Mastre, Brray & Cris Mj - "Beso de 3"
Oh Wonder - "Fuck It I Love You"
Ozuna & Boza - "Apretaito"
Revol & Darell - "Dónde Estás"
Skylar Grey - "Show Me Where It Hurts"
Soulja Boy - "Hold It Down"
Travie McCoy - "Stop It"
Vance Joy - "Clarity"
陳慧敏 (Vivian Chan) - "泰姬 (Taj)"
YOVNGCHIMI, Eladio Carrión & Hydro - "Glizzy Walk 2.5"
4/8
24kGoldn - "SCAR" ft. sokodomo
7xvethegenius - "Always Thank God" ft. Trae tha Truth
7xvethegenius - "Numbers"
Adri Torrón - "Háblame Claro"
Alice Merton - "Blindside"
Allison Ponthier - "Autopilot"
almost monday - "sunburn"
Ángela Aguilar - "Always On My Mind (Banda Sonora de la Serie Amsterdam)"
Animal Sun - "I'M ALREADY DEAD" ft. DREAMERS
Armin Van Buuren & Billen Ted - "Come Around Again" ft. JC Stewart
AUGUST 08 - "500 Days"
Awgust - "Boys Don't Cry"
BAD NEIGHBOR$ - "Vampire Diaries" ft. Lil Tracy
Bankrol Hayden - "Fuck Love"
Bankroll Freddie & Icewear Vezzo - "Pickin' Sides"
BIA - "LONDON" ft. J. Cole
BIGBABYGUCCI - "Outta State"
BigKayBeezy - "Misfit"
Big Yavo - "Cabbage Patch"
Bishop Briggs - "Art of Survival"
Bishop Briggs - "High Water"
Blackinny - "INTRO"
Blac Youngsta - "Can’t Spell"
Brett Young - "Long Way Home"
Cally Rhodes - "Life is Hard"
Camila Cabello - "psychofreak" ft. WILLOW
Carrie Underwood - "Denim & Rhinestones"
Charlie Puth - "That's Hilarious"
Charlotte Jane - "​10 percent"
Chenzo y Dezz & ElDiez10 - "Pa' Verte de Nuevo"
Chlöe - "Treat Me"
CORPSE - "POLTERGEIST!" ft. OmenXIII
Crissin - "Ácido"
DAGames, Saster - "Freaky Machine"
Dalmata, Totoy El Frio & PJ Sin Suela - "D.A.T.A."
Dani Barranco - "​cuando un te amo es triste"
David Guetta, Becky Hill & Ella Henderson - "Crazy What Love Can Do"
Doechii - "Crazy"
Drippin So Pretty - "Betrayed"
EDDISON & Afourteen - "Cullinan"
Eliza & The Delusionals - "Halloween"
Empress Of - "Save Me"
ericdoa - "lifeline"
FCG Heem - "Headlock" ft. Hotboii
Fousheé - "double standard"
Fran Mera - "Buchanan's"
G Perico - "It's Over"
Gente De Zona & Carlos Vives - "El Negrito"
George Cosby - "Paris"
Gonzy - "Uno Pal Otro"
Gracie Abrams - "Block me out"
Greta Isaac - "PAYRI$E"
Guapdad 4000 - "Black Iverson - A COLORS SHOW"
Hackle - "DUMBO" ft. Buckshot
Hanna Emilie - "Stay Numb"
Haywood - "Human to Fall Apart"
IDK - "Taco"
Imanbek & ​salem ilese - "Married to Your Melody"
陳凱詠 (Jace Chan) - "Long D"
Jack Harlow - "First Class"
Jack Johnson - "One Step Ahead"
Jim Jones, Lil Wayne & DJ Khaled - "We Set The Trends (Remix)" ft. Juelz Santana & Migos
J.I The Prince Of N.Y - "Toxic"
Kaien Cruz - "Anything U Want"
Karen Méndez & Juacko - "Fotos"
Kate Stewart - "Numb"
Kelsea Ballerini - "HEARTFIRST"
Kenyon Dixon - "Get High, Get By" ft. D Smoke
Koe Wetzel - "April Showers"
Lauv - "All 4 Nothing (I'm So In Love)"
LeAnn Rimes - "how much a heart can hold"
Lil Baby - "In A Minute"
Lil Baby - "Right On"
Lil Boom - "Yesterday"
Lil Dan & Brray - "Ella Quiere"
Lil Zay Osama - "Real Pain"
Lola Indigo - "Toy Story"
LØLØ - "Junkie"
Lostboycrow - "Chewed Up"
Maggie Rogers - "That's Where I Am"
Marty & Fernanda - "365"
Matteo Bocelli & Sebastián Yatra - "Tu Luz Quedó"
Maude Latour - "Lola"
Metteson - "Second Heart"
Mike Posner - "Home"
Milow - "How Love Works"
Navos & Galantis - "What It Feels Like" ft. YOU
Nickgeorge - "Joseando" ft. Alejo
NLE Choppa - "Sleazy Flow Freestyle"
NO1-NOAH - "Bonjour" ft. Summer Walker
Noah Cyrus - "I Burned LA Down"
Omar Courtz - "En Tu Cuerpo"
Pol Granch - "No Te Bastó, Mi Corazón"
Pollari - "4AM in Agoura"
Portion - "Eastside" ft. Toosii
Powfu - "draw you inside my book"
Prentiss - "​let myself go"
Rapeton Approved & Sael - "Del Mar"
Rexx Life Raj - "Jerry Curl" ft. Larry June
Rhys Lewis - "Alone"
Rocco Hunt, Omar Montes & Reik - "Solo quiero dedicarte"
Rowdy Rebel - "Rowdy vs Rebel"
Royal & the Serpent - "Happier In Hell"
Saak - "Delicuente"
Sasha Alex Sloan - "I Blame the World"
Scarlet Pleasure - "TO DIE FOR"
Sig.Carlito - "best :P"
Simple Plan - "Wake Me Up (When This Nightmare’s Over)"
SKAAR - "Get Him Away From Me"
Skylar Stecker - "What's Good" ft. Tone Stith
Slump6s - "Own It"
Spacey Jane - "It's Been a Long Day"
Spice, Demarco & Meeka - "Jiggle"
The Faim - "ERA"
The Knocks - "Bang Bang" ft. Donna Missal
TIMØ & Pitizion - "Canción de Amor"
Tyga - "Lifetime"
Unlike Pluto - "Have Fun"
will hyde - "​i always end up leaving."
Zelly Ocho - "Section 8"
ZHR - "Something Ain’t Right"
4/9
Tory Lanez - "Mucky James"
​wolfacejoeyy - "gi joe"
4/10
BasedNas - "China Vibez" ft. KA$HDAMI & Since99
L-Gante & Homer El Mero Mero - "Cementerio" ft. DT.Bilardo & Al Records
MKULTRA - "In My Toilet"
4/11
方皓玟 (Charmaine Fong) - "HW1"
EDDISON & CJ Hunter - "Go"
Little Big Town - "Hell Yeah"
Sig.Carlito - "i can die"
Uffie - "sophia"
4/12
100 gecs - "Doritos & Fritos"
Dear Jane - "脫骹的華爾茲 (Waltz Of The Damaged)"
EDDISON - "on go" ft. drownwithtoga
Five Finger Death Punch - "AfterLife"
Interpol - "Something Changed"
Jamie xx - "LET'S DO IT AGAIN"
Lil Pump - "All the Sudden"
Malucci - "3 y Pico"
Martin Garrix & Matisse and Sadko - "Good Morning"
Martin Lora & Arlene MC - "Tu No Cambia"
Matilda Mann - "Nice"
Muni Long - "Another"
paopao & iZaak - ​"¿qué nos pasó?"
ROBI - "Robot"
Tayc "D O D O (Adekunle Gold Version)" ft. Adekunle Gold
TOKiMONSTA & morgxn - "Loved By U"
wifisfuneral - "Let Me Fly"
4/13
Alfie Templeman - "Colour Me Blue"
Belle and Sebastian - "Young and Stupid"
Danny Beau - "text back"
Eix, Dalex & Juhn - "Tour (Remix)"
Faye Webster - "Car Therapy"
Gavin DeGraw - "Face the River"
Jeshi - "Protein" ft. Obongjayar
KHEA - "Young Flex"
Lil Pump - "All The Sudden"
MC 張天賦 - "小心地滑 (Caution Wet Floor)"
MØ - "New Moon (Remix)" ft. Rebecca Black
Mysie - "fade"
Ovi, Alemán & Noriel - "Ya Ni Sé"
Quando Rondo - "24"
Running Touch - "Why Do I"
Sig.Carlito - "imy2" ft. Zzz.
Squash - "Lattry"
Troye Sivan - "Angel Baby (Acoustic)"
Wet - "Where Did the Day Go"
Will Young - "Why Does It Hurt"
4/14
Afourteen - "PENIS MUSIC 2: TAKE 1"
Akemi Fox - "See You Soon"
Asan - "Frío Polar"
Big Soto - "Rosa"
boyband - "STOP IT!" ft. Billy Martin
CHRIST DILLINGER - "ME AND MADJAX GOT BEEF" ft. MADJAX
DEZ 余宗遙 - "綠洲 (Paradise)"
DJ Tao, Kaleb Di Masi & LIT killah - "De Lao a Lao: Turreo Sessions #5 (Remix)" ft. Alan Gomez, Javiielo & Omy De Oro
Duwap Kaine - "64/7"
ECKO - "Copacabana"
iamamiwhoami - "zeven"
Ibeyi & Jorja Smith - "Lavender & Roses (Champion Remix)"
Ir Sais - "Claramente"
Jake Bugg - "Seven Bridge Road"
Lauren Spencer-Smith - "Flowers"
Lizzo - "About Damn Time"
LocateEmilio - "tears"
Los Palmeras & Neo Pistea - "Macumbia"
Mallrat - "Surprise Me" ft. Azealia Banks
MC $oHo & KidNey - "夢想成真2022" ft. 譚仔女聲合唱團 (Tam Jai Women's Choir)
Mitch - "Shadeborough"
Ricky Martin & Reik - "A Veces Bien Y A Veces Mal"
Russ Millions - "Backseat"
Samantha Barrón & Leon Leiden - "Mala Vida"
Tomberlin - "sunstruck"
Train - "Running Back (Trying to Talk to You)"
Tunji Ige - "IMA ARTIST NOT a SOCIALITE"
Why Don't We - "Let Me Down Easy (Lie)"
Zion & Lennox & Revol - "Tus Labios"
4/15
6ix9ine - "GINÉ"
Aleyna Tilki - "Take it or Leave It"
Amelia Moore - "crybaby"
AronChupa & Flamingoz - "Coco Song"
AViVA - "SCREAM"
​ayokay - "If That's What You Need"
Benjamin Ingrosso - "Afterlife"
Benjamin Ingrosso - "Queens"
Big Yavo - "Yayski"
Blueface & G Herbo - "Street Signs"
BRUHMANEGOD - "the only song i ever drop that will sound like this"
CHASETHEMONEY & MVW - "99 Problems" ft. Valee & Babyface Ray
Clever - "Turn Out the Light"
Conan Gray - "Memories"
Craig David - "My Heart's Been Waiting For You" ft. Duvall
Cris Mj & Gotay "El Autentiko" - "Yo No Me Olvido"
DDG - "Ye Vs. Skete “Freestyle”"
Desiigner - "Topless"
Dev Lemons - "Autopilot"
Duke Deuce - "Running Out Of Love" ft. Dante Smith
Elisama - "Bajo"
Farina & Ryan Castro - "Fiesta"
Fátima Pinto - "Amor de Esos"
Fredo Bang & Roddy Ricch - "Last One Left"
gavn! - "Madelyne"
G Perico & Curren$y - "Bacc 2 The Blocc"
Gucci Mane - "Serial Killers"
HXLLYWOOD - "Don’t Matter" ft. Luh Kel & Toosii
Ingrid Andress - "Good Person"
Jade LeMac - "Aimed To Kill"
Jae Lynx - "Floss My Teeth"
Jeeiph - "CULPABLE"
Kay Flock, Cardi B & Dougie B - "Shake It" ft. Bory300
KESHORE - "Sweet"
Kill Jasper - "Better4U"
Kota The Friend - "Good Friday"
Lalo Ebratt, DEKKO & Yera - "Amor Con Odio"
Lil Boom - "Cloud’s Theme"
Lil Boom - "Mom Lovers Anthem"
Mak Sauce & Ray J - "Wish"
Maliibu Miitch - "Letter To My Ex"
Martin Garrix & DubVision - "Starlight (Keep Me Afloat)" ft. Shaun Farrugia
Max Frost - "Cool Kids"
MDMA - "Whitaker"
Morgan Wallen - "Don't Think Jesus"
Mt. Joy - "Orange Blood"
my little airport - "LUNCH"
Nascar Aloe - "TAKE OVER" ft. ​rirugiliyangugili & Yokai Jaki
Nevaeh Jolie - "Chew Me"
Night Lovell - "Mr. Make Her Dance"
Niko Moon - "EASY TONIGHT"
NoCap - "Very Special"
Otis Kane - "Free"
Phoebe Bridgers - "Sidelines"
Quin NFN - "ROKU"
Ransom - "Circumstances" ft. The Game
Reiley - "blah blah blah"
RHODES - "Suffering"
Richie Campbell - "Let You Go"
Robb Bank$ - "MAY I" ft. XXXTENTACION & Ski Mask the Slump God
Santana - "Yo Estaré" ft. Ally Brooke
Sheryl Crow - "Live With Me"
SosMula - "SNAP"
​SSGKobe - "REAL LIES"
Teddy Swims - "​dose"
Teejay - "​Different Species"
Tom Aspaul - "What Is Real Anymore?"
Trina & Latto - "Clap"
Tyga, Doja Cat & R3HAB - "Freaky Deaky (R3HAB Remix)"
Unlike Pluto - "Comatose Scenery"
Whethan - "COMPLICATED" ft. aldn & 8485
Willie Gomez - "Vicio"
4/16
DIFFERENT BRXXD - "Switchin' Lanes"
Jay Critch - "Spin No Blocks"
Since99 - "​​how will did chris"
4/18
Jackboy - "Pardon Me"
Jesse & Joy - "Clichés"
Kelis - "FEED THEM"
MKULTRA - "You Mean Nothing To Me"
吳保錡 (Poki Ng) - "猥瑣 (Obscene)"
Soulja Boy - "Blue Cheese"
4/19
BabyTron - "Type Shit"
easy life - "BEESWAX"
Fontaines D.C. - "Roman Holiday"
Hot Chip - "Down"
​nothing,nowhere. - "Memory Fracture"
​koi - "clearly"
Of Monsters and Men - "This Happiness"
Ravyn Lenae - "M.I.A."
Ruth Radelet - "Crimes"
YoSoyJenn - "Juntos Forever"
Young M.A - "Aye Day Pay Day"
Zola Jesus - "Desire"
Kanon - "No Limits"
4/20
AK4:20 & Brray - "MARIMBA GRINGA"
Alemán & L-Gante - "Requisito 420"
Bear's Den - "Frightened Whispers"
BIG30 -"King Of My Projects (Grizz Mix)"
Becky G - "NO MIENTEN"
Ben Carrillo & Amenazzy - "Marijuana"
Bill Wurtz - "at the corner store"
Blu Samu - "Amor"
BRS Kash - "Let Me In"
BRUHMANEGOD - "​​rampart"
C-Kan - "Toma 4"
Dani Ribba & Duki - "Lo Olvidaste"
Editors - "Heart Attack"
Florence + the Machine - "Free"
Gabbie Hanna - "Head in the Clouds"
Haiti Babii - "N.P.O" ft. Blueface
林海峰 (Jan Lamb) - "世間始終你好 (You Are The Sunshine Of My Life)"
Jer 柳應廷 - "離別的規矩 (Rules for Leaving)"
Josh Levi - "Vices"
KEVVO & Chucky73 - "Bancario"
Lykke Li - "HIGHWAY TO YOUR HEART"
Marcianeke & L-Gante - "Toma"
MORGAN - "In My Feelings"
Nick Mulvey - "Brother To You"
Nina Nesbitt - "Dinner Table"
Paradize & JonLee - "Pre Roll"
Purity Ring - "graves"
Rico Nasty - "Vaderz" ft. BKTHERULA
Rozzi - "Consequences" ft. Nile Rodgers
Sean Paul - "No Fear" ft. Damian Marley & Nicky Jam
Sinead O'Brien - "There Are Good Times Coming"
Slimelife Shawty - "Big Biznezz"
Soccer Mommy - "Unholy Affliction"
sophie meiers - "things will change"
Tank and the Bangas - "Oak Tree"
Tourist - "Avalanche"
泳兒 (Vincy Chan) - "早上37.2度 (Bloody Warmth)"
4/21
Chelsea Jade - "Best Behaviour"
Don Omar, Wisin & Gente de Zona - "Soy Yo"
Drippin So Pretty - "Fingertips"
EASYFUN - "Audio"
Eizander - "Pensándote"
Ethel Cain - "American Teenager"
Ha*Ash - "Mejor Que Te Acostumbres"
Hazel English - "Summer Nights"
iamamiwhoami - "i tenacious"
Jack Savoretti - "Dancing Through The Rain"
Jay Critch - "Stamped"
KAROL G - "PROVENZA"
Lefty Sm & La Santa Grifa - "Orgullo Café"
Leon Leiden & Adriel Favela - "Estamos Aquí"
Lil Poppa & Yo Gotti - "H Spot"
Lyanno - "Nasty"
M1llionz & Munna Duke - "10 TO DA O"
Monaleo & Flo Milli - "We Not Humping (Remix)"
NoCap - "Save The Day" ft. Kodak Black
Protoje - "HILLS"
Rels B - "No Sabe Igual"
Rosie Carney - "break the ground"
陳珊妮 (Sandee Chan) - "他說 (S/he Said)"
Shakira & Rauw Alejandro - "Te Felicito"
Sigrid & Bring Me The Horizon - "Bad Life"
​SSGKobe - "PILL POPPER"
Telenova - "Why Do I Keep You?"
Tommy Boysen - "SUDÁ" ft. Drago200
Triple G - "GIGGLE"
Yorke - "next life"
Yoss Bones & Toser One - "Nada Discreto"
4/22
$UICIDEBOY$ - "THE_EVIL_THAT_MEN_DO"
070 Shake - "Skin & Bones"
83HADES - "WTF" ft. Kamiyada+
88GLAM - "Happy Belated"
220 KID & ASDIS - "Release"
Ab-Soul - "Hollandaise"
AGNEZ MO - "Patience (Remix)" ft. D Smoke
Alejo & Lil Joujou - "Deja el misterio"
Alesso & Zara Larsson - "Words"
Alvaro Soler & Topic - "Solo Para Ti"
Arin Ray - "The Mood" ft. D Smoke
Acid Souljah - "Miss The Trap" ft. RXKNephew
Baby Queen - "Colours of You"
BabyTron - "Euphoria"
Bahari & Yoshi Flower - "Hot Mess"
Bella Dose - "Bite"
Bhavi - "Sienta Bien" ft. Laylow
Bow Anderson - "Mama Said"
Brevin Kim - "CAN'T HANDLE IT"
Brett Eldredge - "Songs About You"
Brother Leo - "Caroline"
Carmen DeLeon - "BBB"
Carrie Underwood - "Crazy Angels"
Casey Bishop - "Bad Dream"
Casey Veggies - "Royalty" ft. DOM KENNEDY
Cassia - "Not Enough Time to Think (Edit)"
Cheat Codes - "Tell Me You Love Me"
Christian Nodal - "Aguardiente"
Conor Maynard - "P.G.N.L."
Corina Smith - "Los Tweets"
CuteBad - "You Don't Really Wanna"
Daniel Caesar - "PLEASE DO NOT LEAN"
Desiigner - "420"
DreamDoll - "Ice Cream Dream" ft. French Montana
Dynoro, HVME & Gaudini - "Why Why Why"
Eagle-Eye Cherry - "Rising Sun"
Ed Sheeran - "2 Step (Remix)" ft. Lil Baby
EDDISON - "​cant nobody do it like me"
El Chulo - "Mala Actitud"
Eric Bellinger - "​Truly Yours (Remix)" ft. Phabo, The Game & DOM KENNEDY
Erica Banks - "Pop Out"
Ewan Mainwood - "No One Saving Me"
Fredo Bang & YNW Melly - "Brazy"
Futuristic - "I Don't Really Care"
Gareth Emery - "This Is Not the End" ft Roddy Woomble
George Ezra - "Green Green Grass"
GRANT - "Tilt"
Hey Violet - "Fall for Me First"
Isaac Dunbar - "Fool's Paradise"
Jade Novah - "Lost in You"
James Vincent McMorrow - "The Less I Knew"
Jay Critch - "Anyday"
Jayson Cash - "Top Down"
Johnny Orlando - "someone will love you better"
Jon Vinyl & Avry - "Favours"
Jorge Drexler - "Tinta y Tiempo"
José Madero - "Soy el Diluvio"
Josie Man - "by the end of the night"
JP Saxe - "A Little Bit Yours (Mandarin Version)" ft. 周興哲 (Eric Chou)
Juniper & Sango - "Tell Me"
Justine Skye - "What a Lie"
Kany García & Rozalén - "Justito a Tiempo"
Kid Ink & Verse Simmonds - "While We Dancing"
Kristiane - "Cry Baby"
KT Tunstall - "Resolution Song (United Kingdom)"
Lauren Aquilina - "Hanging by Your Halo"
Liam Gallagher - "Better Days"
Logic - "Decades"
Logic - "Tetris"
Los Ángeles Azules, Sofía Reyes & Esteman - "Esa Parte de Mí"
Luke Combs - "Tomorrow Me"
Luna Ki & Lola Indigo - "Piketaison"
Martin Garrix & Justin Mylo - "Find You" ft. Dewain Whitmore
Martin Jensen & FAST BOY - "One Day"
Matt Paris - "La Duda"
Megan Thee Stallion - "Plan B"
mehro - "parasite"
Monsieur Nov - "Ce que tu m'as fait"
Mosa Wild - "I Might Let You Down"
Nia Sultana - "In The Morning"
NLE Choppa - "Slut Me Out"
Noreh - "DCDT"
Ofenbach - "4U"
Olivera - "Repeat This Song"
Peter Nieto & Ivy Queen - "Pa'mi"
PinkPantheress - "Where You Are" ft. WILLOW
piri & Tommy Villiers - "​words"
PJ Morton - "Be Like Water" ft. Stevie Wonder & Nas
Pollari - "Runner!"
Roxette & Galantis - "Fading Like a Flower"
Ryan Castro, Justin Quiles & Symon Dice - "Mírate Bien"
Sara Kays - "Math"
Skip Marley - "Change"
Sobrino - "Nada Tuyo"
Sofía Hervier - "Lento"
Southside & Future - "Hold That Heat" ft. Travis Scott
Soy Emilia - "Sugar Daddy"
Sub Urban & BENEE - "UH OH!"
Tay Keith - "Lights Off" ft. Gunna & Lil Durk
The Chainsmokers - "Riptide"
The Kid LAROI - "Thousand Miles"
TiaCorine - "Gas Station"
TIEKS & MNEK - "The Funk"
Tom Speight - "You & I"
Tomine Harket - "Psychopath"
Tory Lanez - "I LIKE"
Unlike Pluto - "Crash and Burn"
​vf7 - "Llorando en Mex"
Vök - "Miss Confidence"
Warpaint - "Hips"
WESTSIDE BOOGIE & Shelley FKA DRAM - "AIGHT"
Zxmyr - "El Cholo y La Fresa"
4/23
Louie Ray - "Bar Louie"
4/24
EDDISON - "​​all i need"
Flume & QUIET BISON - "Escape" ft. KUČKA
Flume - "Palaces" ft. Damon Albarn
4/25
Alkaline - "Valum"
beabadoobee - "See you Soon"
Bizarrap & Paulo Londra - "Paulo Londra: Bzrp Music Sessions, Vol. 23"
Carlos Vives - "Solo"
洪嘉豪 (Hung Kaho) - "活人鏢靶 (The Dartboard)"
Jackboy - "Prize" ft. Lexxstasy
Lil Shordie Scott - "Rockin A Cardigan In Atlanta (Remix)" ft. Offset
Mars Argo - "Angry"
MIRROR - "Innerspace"
4/26
Alex Porat - "Pity Party"
Aluna & Jayda G - "Mine O' Mine"
BIGBABYGUCCI - "No Smoke"
Edén Muñoz - "Te Voy a Encontrar"
Elsa y Elmar - "vuelve"
Faye Webster - "Suite: Jonny"
Hozwal & El Clooy - "Cuéntale"
Lil Gotit - "Rich Shit" ft. Ty Dolla $ign & Lil Keed
Mandy Moore - "Four Moons"
Martin Garrix & Blinders - "Aurora"
ODESZA - "Behind the Sun"
PGF Nuk - "4PF"
Sin Bandera - "Cuando Te Vuelva a Ver"
Since99 - "Applying the pressure"
Young Nudy & BabyDrill - "Duntsane"
4/27
Akuna, El Cherry Scom & Leo RD - "BICHO"
Angel Olsen - "Big Time"
Arcade Fire - "Unconditional I (Lookout Kid)"
Asian Doll - "Talk Facts"
Big Jade - "Lower"
BRUHMANEGOD - "cleric beat"
Daniela Darcourt & Tito Nieves - "No Me Lo Creo"
Emilee - "Hida's House"
Fonseca & Matisse - "Pasa"
Ibeyi - "Rise Above"
Ivana - "Recuerdos Que Torturan"
馮允謙 (Jay Fung) - "Freakin' Nightmare"
Justin Bieber - "I Feel Funny"
Kris Floyd - "C100EN"
La Gabi - "KARMA"
Lolo Zouaï - "Give Me a Kiss"
Madeon - "Love You Back"
Mahalia - "In The Club"
mxmtoon - "victim of nostalgia"
per se - "竊竊詩 (The Prophet)"
ROBI, Dalex & Eix - "3 Deseos (Remix)" ft. Alejo
Röyksopp - "If You Want Me" ft. Susanne Sundfør
Sampa The Great - "Lane" ft. Denzel Curry
Superorganism - "​​​​crushed.zip"
The Black Keys - "It Ain't Over"
The Lumineers - "just like heaven"
Zolita - "I Fucking Love You"
4/28
Alex Mali - "Clearly"
Andrez Babii - "123 Enemies"
Ava Max - "Maybe You're the Problem"
Carlos Rivera - "Eres Tú (Mamá)"
Dímelo Flow, Reik & Jay Wheeler - "Winnie Pooh" ft. Boza
ella jane - "Time On"
​fl.vco - "​no more colors"
Gloria Trevi - "Él Se Equivocó"
Gotay "El Autentiko" - "Beneficio"
Gusi & Nacho - "Te Robaré"
HotSpanish - "Ella"
Ingratax - "APAGAITA"
Jon Z & Jory Boy - "Corazón de Hielo"
Kent Jamz - "Rollin’ Wit The Homies" ft. Buddy
Kevin Gates - "Big Lyfe"
Las Villa - "La Carta"
Lexi Jayde - "self sabotage"
Luck Ra & Rusherking - "Te Mentiría Remix"
Macaco & Ana Mena - "La Guerra de los Besos" ft. Bejo
Marca MP & Becky G - "Ya acabó"
Metric - "All Comes Crashing"
MUNA - "Kind of Girl"
Piso 21 & Santa Fe Klan - "Equivocado"
Robledo & Abraham Mateo - "Tu Me Querías (Remix)"
Sam Smith - "Love Me More"
Sia - "Manchild"
Snakehips - "WATER." ft. Bryce Vine
Tegan and Sara - "Fucking Up What Matters"
Valley - "CHAMPAGNE"
Yuridia - "Y Tú, ¿Qué Ganas?"
Zakhar - "Lights Out"
Zion & Lennox & Danny Ocean - "Brisa"
Kanon - "Dobermann"
4/29
3Breezy & Toosii - "Gangsta Wit It (Pt. 2)"
Aazar - "The Carnival" ft. French Montana, Mariah Angeliq, Zaac & Dany Synthé
Aina Maro, Leslie Shaw & Blue Mary - "No Vale la Pena"
Alan Walker - "The Drum"
Anson Seabra - "Peter Pan Was Right"
Antonio Orozco & Sebastián Yatra - "Entre Sobras y Sobras Me Faltas"
Arizona Zervas - "EVER AGAIN"
Babi - "Flores"
Baby Tate - "Dancing Queen"
Baby Tate - "Yasss Queen"
Benson Boone - "In the Stars"
BFB Da Packman - "Lost With Miami"
BigKayBeezy - "Southside"
Bobby Shmurda - "They Don't Know"
Calum Scott - "Heaven"
Carla Morrison - "Diamantes"
Chimbala & Tony Brey - "Banda"
Clean Bandit & Darkoo - "Everything But You (Remix)" ft. Backroad Gee & Young Chencs
COLLAR - "Gotta Go!"
Dayme y El High, Brray & Tito "El Bambino" - "No te quites" ft. Rayvanny
DJ Nelson & Ferro - "Santa"
Don Patricio - "El Pueblo en la Casa"
FKJ - "Way Out"
Fuego, R3HAB & Duki - "Una Vaina Loca R3hab Remix" ft. Manuel Turizo
GIVĒON - "Lie Again"
Grace Kinstler - "Breaking Myself"
Guapdad 4000 - "Black Iverson"
Harlee - "Reset"
Holly Humberstone - "Sleep Tight"
IDK - "Dog Food" ft. Denzel Curry
Internet Money & Yeat - "No Handoutz"
Jake Owen - "1X1"
Jenny69, Dj Morphius & Muzik Junkies - "Buchona Vibez"
Jnr Choi - "TO THE MOON (Remix)" ft. M24, Russ Millions, G Herbo & Fivio Foreign
Jodosky & Auudi - "No Fumaba"
JonLee - "Pensando en Ti"
Justin Bieber - "Honest" ft. Don Toliver
KA$HDAMI - "Phoenix"
Kaash Paige - "Girlfriend"
Khalid - "Skyline"
KREAM & Jake Tarry - "Once Again"
La Perversa & Lírico En La Casa - "Esa Flaca"
LAGOS - "Tengamos Pasado"
Leroy Sanchez - "Por Siempre Jamás"
Lil Baby - "Frozen"
Lil Gnar - "No Switches" ft. Tory Lanez
Lil Gotit - "Rich Shit" ft. Ty Dolla $ign & Lil Keed
Lil Mexico & Lil Durk - "Can't Lose"
Lil Tjay - "Goin Up"
Lindsay Ell - "Right On Time"
Maddie Poppe - "One That Got Away"
Maggie Lindemann - "how could you do this to me" ft. Kellin Quinn
Manast LL' - FWTS feat. THE VENICE
Manu Manzo & LATENIGHTJIGGY - "Sensualidad"
Marco Mares - "Match"
Marshmello & Tokischa - "ESTILAZO"
MAX - "Gucci Bag"
Miya Folick - "Oh God"
Nardo Wick - "Krazy Krazy"
Ola Runt - "Teardrop"
Oriana - "325"
Pablo Pesadilla, Cris Mj & Harry Nach - "Baby Doll"
Pedro Capó - "La Fiesta"
Reykon - "Bandidos"
RIVAS - "EVA"
Sasha Keable & Jorja Smith - "Killing Me (acoustic)"
Scorey - "Oh, Oh"
Sharlene - "20 Minutos"
Softest Hard - "La Luz" ft. Kali Uchis
SpotEmGottem - "Creep When I Step"
Steve Aoki & HRVY - "Save Me"
The Stupendium - "The Toybox"
T-Pain - "That’s Just Tips"
The Hertz - "人 (Mankind)"
Tink & 2 Chainz - "Cater"
Tom Walker - "Serotonin"
Tommy Royale - "Gitana"
UMI - "whatever u like"
Unlike Pluto - "Against the Timeline"
West Blanco & Noreh - "San Andrés"
YoGambii - "Fuego"
YSN Flow - "Hotbox"
Yung Boi - "Reality"
4/30
​gizmo - "At The Beach"
Lena Mædgen - "Quit."
姜濤 (Keung To) - "作品的説話 (What the Work Says)"
​SSGKobe - "NO L'S"
Tory Lanez - "London (

For February 2023 album releases, visit this page

This page highlights the notable singles released in all genres throughout February 2023.… Read More 2/1
Anna Shoemaker - "Holly"
Big One, Emilia & Callejero Fino - "En la Intimidad"
​bLAck pARty - "BOMB (Remix)" ft. Latto
Briella - "Electricidad"
daine - "portal"
Dolores Forever - "When I Say So"
Elita - "She Bangs like a Fairy on Acid"
Ellie Goulding - "Like A Saviour"
Girl Ray - "Everybody's Saying That"
Inhaler - "If You're Gonna Break My Heart"
Jake Shears - "Too Much Music"
Kwite - "DGTL footprint"
Maluma & Marc Anthony - "La Fórmula"
Martin Luke Brown - "elsie"
Petite Noir - "Blurry" ft. Sampa The Great
Rachel Chinouriri - "Maybe I'm Lonely"
Sam Nelson - "forever, now"
Tennis - "Forbidden Doors"
The Tallest Man On Earth - "Evеry Little Heart"
2/2
許廷鏗 (Alfred Hui) - "良心發現 (Guilty Consciеnce)"
Cios - "YS30"
Conrad Sewell - "Ferris Wheel"
Franky Style, Obie Wanshot & Awesome Pierre - "Coco"
Hozwal & Young Miko - "Big Booty"
JEUNESAINT - "Pu$$Y Tsunami"
JP Saxe & Camilo - "Moderación"
KAROL G & Romeo Santos – "X SI VOLVEMOS"
Luck Ra, La T y La M & Rusherking - "Quiero Creer"
Peach PRC - "Perfect For You"
Ptazeta & Lola Indigo - "Tiki Tiki"
RAYE - "Ice Cream Man."
Skrillex & Nai Barghouti - "Xena"
Slipknot - "Bone Church"
Unknown Mortal Orchestra - "Layla"
Yami Safdie & Milo j - "El Bolero (acoustic)"
2/3
AK - "Solid"
Alandes & StormyKid - "Mamita Mía"
Amaria - "Get Away"
American Authors - "We Happy"
Anne-Marie - "SAD B!TCH"
ARIA VEGA - "ANONIMATO"
Arizona Zervas - "MISS ME"
Austin Awake & Vory - "Settle"
Beenie Man - "Sail Out"
Betty Who - "Running Up That Hill"
BRELAND - "For What It's Worth (Acoustic)"
Canals - "¿cómo negar?"
Carlie Hanson - "Blueberry Pancakes"
Claire Rosinkranz - "Sad In Hawaii"
Derivakat & Cartian - "Let Me Let You Go"
Dierks Bentley - "Cowboy Boots" ft. Ashley McBryde
Donna Lewis & Digital Farm Animals - "ILYAF (i love you always forever)"
Dreamville, JID & Lute - "Ma Boy"
Drew Sycamore - "In The Club"
Elli Moore - "Green Juice"
Emei - "Scatterbrain"
Enchanting - "Love Shit"
ESSEL & James Hurr - "Hit 'Em Up Style (Oops!)"
FEYZAL - "Should I Let Go"
FL Dusa - "Exhausted" ft. Kevin Gates
GIRLI - "Imposter Syndrome"
GloRilla - "Internet Trolls"
Hannah Grae - "I Never Say No"
James Vickery - "(I Get So) Emotional"
Jay Wheeler - "SOS"
Jonas Blue & Felix Jaehn - "Weekends"
Jordan Davis - "Money Isn't Real"
Kane Brown & Katelyn Brown - "Thank God (Spring Symphony Version)"
Kane Brown & Katelyn Brown - "Thank God (Spring Symphony Instrumental)"
Katie Melua - "Those Sweet Days"
Kuttem Reese - "Parking Lot"
Lily Williams - "How The Story Ends"
Lil Zay Osama - "Humble"
Lizzy McAlpine - "Hold On"
Lyn Lapid & Ruth B. - "Do U Really?"
Marshmello - "Unity"
METTE - "Mama's Eyes"
Mike Posner & salem ilese - "Howling at the Moon"
Milow - "Never Too Late"
Money Musik, NAV & SoFaygo - "Double Faces"
NEA - "A Lover Like Me"
NERIAH - "FALLING 4 SOMEBODY"
Nia Archives - "Conveniency"
Nicky Romero - "Turn Off The Lights"
NLE Choppa - "Champions"
OldPurp & Yung Beef - "En Verda" ft. GoldChains & Marko Lenz
Owl City - "Adam, Check Please"
PinkPantheress & Ice Spice - "Boy's a liar Pt. 2"
Powfu - "life in a locker" ft. Jomie & Skinny Atlas
Rob49 - "4GOD II"
ROSIE - "Startover"
Russ - "Can't Get This Right"
Sam Fischer - "You Don't Call Me Anymore"
Sessi - "Flexa"
Sigala & MNEK - "Radio (SILK Remix)"
Steve Aoki & CNCO - "Diferente"
The Wombats - "Is This What It Feels Like to Feel Like This? (Myd Remix Radio Edit)"
Tink - "Toxic"
Tones and I - "I Made It"
Ward Thomas - "Loved by You"
YONAKA - "PANIC"
Zak Abel - "What Love Is"
黃凱逸 (Zelos Wong) - "吟鈴 (In Control)"
2/5
Peter Gabriel - "The Court (Dark-Side Mix)"
2/6
Barrie - "Races"
Big Time Rush - "Can't Get Enough"
Billie Marten - "Nothing But Mine"
Juanse & J. Lemón - "Mariposas"
2/7
Bakar - "Good News"
Dream Wife - "Hot (Don't Date a Musician)"
Harriette - "Goodbye Texas"
Kate Davis - "Call Home"
Kelela - "Enough for Love"
Logic - "Paradise II" ft. Norah Jones
LUDMILLA - "Sou Má" ft. Tasha & Tracie
Miles Chancellor - "Mistakes"
Nicole Millar - "hugs"
slowthai - "Feel Good"
Yaya Bey - "exodus the north star"
Yot Club - "A/I WRITTEN YOT CLUB SONG"
You Me At Six - "God Bless the 90s Kids"
2/8
A R I Z O N A - "Moving On"
Ashnikko - "You Make Me Sick!"
Babyface Ray & 42 Dugg - "Ron Artest"
BENEE - "Green Honda"
Blessd - "AP"
Budjerah - "Therapy"
Chiiild - "Antidote"
Coach Party - "Micro Aggression"
Daughter - "Party"
Fran Rozzano - "Como Sabes"
Gengahr - "A Ladder"
Indigo De Souza - "Younger and Dumber"
Jack River & Genesis Owusu - "Endless Summer"
kmoe - "crush"
Li Rye - "RACKS" ft. Anti Da Menace
Mysie - "CTRL"
SHY Martin - "late night thoughts"
Sophie Ellis-Bextor - "Breaking the Circle"
Squid - "Swing (In a Dream)"
Ten Tonnes - "Monday Morning"
The Plot In You - "Left Behind
2/9
3AM - "Emeycé" ft. Danny Ocean
Abraham Mateo & Luis Fonsi - "Bora Bora"
Álvaro Díaz & Sen Senra - "1000CANCIONES"
Baby Rose - "I Won't Tell" ft. Smino
Babyface - "As a Matter of Fact"
Central Cee - "Me & You"
Cyclo - "Libertad"
Depeche Mode - "Ghosts Again"
El Alfa & Prince Royce - "LE DOY 20 MIL"
flowerovlove - "Love You"
Jason Derulo & David Guetta - "Saturday/Sunday"
Jean Deaux - "JD's Revenge"
Jessie Ware - "Pearls"
Kevin Roldán & Bryant Myers - "S.E.X.O"
Kim Loaiza - "Infieles"
Lasso - "Los Hombres Son Todos Iguales"
Lenny Tavárez - "Felicidades"
Lizzo - "Special (Remix)" ft. SZA
Marshmello - "Eternal"
Mau y Ricky - "Miami"
Now United - "It's Gonna Be Alright"
Sael - "Europeo"
Symon Dice & CNCO - "Borrachita"
Whitney Houston - "Testimony"
2/10
Adriel Favela - "En Este Amor"
Ali Gatie - "All Comes Back To You"
Ayra Starr - "Sability"
Bad Gyal - "Chulo"
Bailey Zimmerman - "Fix'n To Break"
Barely Alive & Kompany - "T.O.A.D."
Beck - "Thinking About You"
Billy Raffoul - "Bliss"
BoyWithUke - "Rockstar"
Bryce Vine - "Gold Rush"
Clara Mae - "When You're Young"
Col3trane - "Simp"
CuteBad - "Hot Stuff"
CXLOE - "Cheating on Myself"
Daniel Caesar - "Let Me Go"
Dhurata Dora - "Sonne"
DJ Scheme, Ski Mask the Slump God & Danny Towers - "Florida Waters" ft. Luh Tyler
Dove Cameron & Khalid - "We Go Down Together"
Dudi - "2 Extraños"
Eddie Benjamin - "All for Nothing"
Ella Vos & Tei Shi - "Salty"
Emilie Nicolas - "Everyday"
French Montana & 2Rare - "RATATAAAAA"
Gracie Abrams - "Amelie"
griffin tomaino - "Okay Without You"
Jahmiel - "Letter to My Kids"
Janine - "If I Call"
Jasiah - "RED EYES BLACK DRAGON" ft. 1nonly
JAWNY - "fall in love"
Jax Jones & Calum Scott - "Whistle"
Jeremy Zucker - "internet crush"
Jordan Ward - "CHERIMOYA"
Jordin Sparks - "STADIUMS"
Jubël - "No More Tears"
Karol Sevilla - "Miedo de Sentir"
Kevin Gates - "Breakfast"
KB Mike - "Rider"
Lauren Spencer-Smith - "Best Friend Breakup"
Lennixx - "I Might"
LG Malique - "Too Easy"
Lil Darius - "Pimpin Ain't Easy"
Linkin Park - "Lost"
Logan Michael - "Whiskey Serenade"
Lovejoy - "Call Me What You Like"
Lucky Daye - "Careful"
Luke Combs - "Love You Anyway"
Mae Stephens - "If We Ever Broke Up"
Maeta - "S(EX)"
Masego - "Two Sides"
Masicka & Jahshii - "Pieces"
Mckenna Grace - "Checkered Vans"
Moby - "In This World (Resound NYC Version)" ft. Marisha Wallace & Nicole Scherzinger
NAV - "Lately"
otuka - "never enough"
Peking Duk - "I Want You" ft. Darren Hayes
Phillip Phillips - "Dancing With Your Shadows"
Plain White T's - "Spaghetti Tattoo"
Project Peters - "Circle of Friends"
RINI - "My Luv"
Roy Woods - "Don't Love Me"
Ryan Destiny - "Lie Like That"
Saiko & The Prodigiez - "Sikora"
Sam Hunt - "Walmart"
Shawn Christmas - "Hadaka no Yuusha"
Skylar Grey - "Love the Way You Lie Part III"
Stela Cole - "Roses"
tan feelz - "Medicate"
Taylor Swift - "Lavender Haze (Felix Jaehn Remix)"
The Kid LAROI - "Kids Are Growing Up (Part 1)"
The Living Tombstone & CG5 - "4GET" ft. OR3O
Tom Speight - "If This Is How the Story Ends"
Tove Lo - "Borderline"
VINCINT - "Romance"
Wasia Project - "Petals On The Moon"
YG & Lambo4oe - "Let's Ride" ft. Ty Dolla $ign
Zacari - "Motions" ft. Ab-Soul
Zeballos - "Sold Out"
2/12
Seal - "Kiss From a Rose (2023)"
2/13
Ely Blancarte - "After Party" ft. Saga WhiteBlack
JONTY - "Pd: No +"
Rauw Alejandro & Angel Dior - "TAMO EN NOTA"
serpentwithfeet - "Gonna Go"
Skrillex, Bibi Bourelly & Sonny Moore - "Don't Get Too Close"
The Lemon Twigs - "Any Time of Day"
Zpecial - "Her"
2/14
A Boogie wit da Hoodie - "No 808s" ft. Vory
All Time Low - "Modern Love"
​beabadoobee - "Glue Song"
Brooke Candy - "Juicy Fruit"
Dear Jane - "懷舊金曲之夜 (Golden Oldies Night)"
Dende - "Nightmares"
Fetty Wap - "Tonight"
Fuerza Regida & Becky G - "Te Quiero Besar"
洪嘉豪 (Hung Kaho) - "My Secret Park"
Iravera - "Leave You Lonely"
Jackboy & Ronny J - "Everyday Valentine's Day"
JULI - "ENCONTRARME"
徐嘉浩 (Kevin Kaho Tsui) - "Lemme"
Lana Del Rey - "A&W"
Lul Bob - "Dey The Ones"
Mae Muller - "As It Was"
Mario - "Used To Me" ft. Ty Dolla $ign
MC 張天賦 (Cheung Tinfu) - "世一 (The One For U) (不可一世 Not For Me)" ft. Kiri T
Now United - "Love Is Love"
P!nk - "When I Get There"
Princess Nokia - "closure"
RubberBand - "戀人日常 (的直線抽擊) (The Basic Strokess in a Relationship)"
Sebastián Cortés - "Cuando Me Tocas"
ThxSoMch - "HATE"
TINI - "Cupido"
Valiant - "Lover Boy"
Vybz Kartel - "Anything You Want Girl"
周殷廷 (Yan Ting) - "My Everything"
Yung Bleu - "Games Women Play"
Zae France - "What It Do" ft. Fridayy
2/15
100 gecs - "Hollywood Baby"
Aly & AJ - "After Hours"
Bea Miller - "cynical"
Don Toliver - "4 Me" ft. Kali Uchis
Jason Mraz - "I Feel Like Dancing"
馮允謙 (Jay Fung) - "入場人士注意 (Bring Out Ya Fire)"
kayan9896 - "Think I’m In Love"
Lauren Spencer-Smith - "28"
Levi Roth - ​"kissed ur girl"
Lucauy - "Sadchata"
Matt Citron - "Do You Think Of Me?"
Now United - "Cotton Candy"
Teo Bok - "Esperanza" ft. Ela Taubert, Joaquina, RIZA, Paola Guanche & JULI
Zakhar - "My One"
2/16
Alison Goldfrapp & Paul Woolford - "Fever"
Anuel AA & Messiah - "Drippin"
Babi & Denom - "Marte"
Christian Nodal - "Un Cumbión Dolido"
COLLAR - "Take Me Away"
Daddy Yankee, Justin Quiles & Dalex - "LA HORA Y EL DÍA"
David Bisbal - "Ajedrez"
Duki - "Si Me Sobrara el Tiempo"
GALE - "Nuestra Canción"
Gera Demara & CNCO - "Extraños"
​isaac gracie - "the man who flew into space"
Janelle Monáe - "Float"
Jhosy - "Zikidown"
­kayan9896 - "Think I’m In Love"
Men I Trust - "Ring of Past"
NF - "HOPE"
Omar Koonze - "DEBAJO DEL MAR"
Reykon - "Zaza (Chimbita)" ft. Xantos, LATENIGHTJIGGY
Robin Schulz - "Sweet Goodbye"
Sebastián Yatra - "Una Noche Sin Pensar"
Tei Shi - "¿QUIÉN TE MANDA?"
2/17
AK - "Sad To The Bank"
Armin van Buuren & Blasterjaxx - "La Bomba"
Astrid S - "Side Effects"
bbno$ - "still"
Bebe Rexha - "Heart Wants What It Wants"
Busy Signal - "Lets Go"
Christian French - "thank god"
Clinton Kane - "Dancing All Alone"
Cloudy June & emlyn - "You Problem"
David Guetta & Marten Hørger - "The Freaks"
Despotem, FLOONK & H3ro - "So Cold"
DJ Drama - "HO4ME" ft. A Boogie wit da Hoodie, Lil Baby
FAST BOY & Topic - "Forget You"
Flo Milli - "Nasty Dancer"
FY - "Habibi (Greek Remix)" ft. Ricky Rich
Grace Gaustad - "The Cloud"
Icona Pop & Galantis - "I Want You"
Karley Scott Collins - "Petty in the 80s"
Kidd Keo - "Solo Freestyle"
Kira Brown & AMEX - "Mi dolor"
Latto - "Lottery" ft. LU KALA
Lostboycrow - Waving Goodbye (Reimagined) ft. Brooke Alexx
Mejiias & bosco herrero - "ORIGEN"
Mimi Webb - "Roles Reversed"
Nessa Barrett - "BANG BANG!"
Niall Horan - "Heaven"
Ninja Sex Party - "I Own A Car"
Nio García & Jay Wheeler - "Aborrecío"
Now United - "Throwback"
OG Parker - "Still Work" ft. Ty Dolla $ign & Muni Long
Omar Apollo - "3 Boys"
piri & tommy - "updown"
Polo G - "No Time Wasted" ft. Future
RealestK - "You & I"
ROLE MODEL - "a little more time"
Sarai - "DURA"
Sam Carter - "Blame It on My Boots"
The Aces - "Always Get This Way"
Timbaland - "Give It To Me (Sped Up Remix)" ft. Justin Timberlake & Nelly Furtado
Trevor Martin - "Can't Call You Beautiful"
Tungevaag & Steerner - "Imma Love You"
Two Friends & SAYGRACE - "No Saving Us"
Vybz Kartel - "From Me Born"
2/18
Maleah Frederick - "I Miss my Old Self"
Now United - "Find Your Fire"
2/19
Victoria Justice - "Last Man Standing"
2/20
張蔓姿 (Gigi Cheung) - "為民除害 (For the People)"
Matt Citron - "Face Taste"
Peter Gabriel - "The Court (Bright-Side Mix)"
2/21
Desiigner - "Two in One"
Dylan - "Every Heart But Mine"
ROA - "UuU" ft. Hades 66
The Band CAMINO - "Told You So"
2/22
Matt Citron - "What You Don't Know"
Teejay - "Weirdo"
2/23
BigWalkDog - "Feeling Like Wop" ft. Gucci Mane
boyband - "DETHKLOK!!"
Lil Wayne - "Kant Nobody" ft. DMX
Matt Citron - "Antics"
Matt Citron - "The Docks
Mike Bahía & Greeicy - "Mi Pecadito"
Now United - "U & Me"
Paulina Rubio - "No es Mi Culpa"
林家謙 (Terence Lam) - "小林不動產 (Lying Down)"
Tiago PZK - "Slow"
WIU - "Só de Mal"
2/24
24kGoldn - "Bite"
A Boogie wit da Hoodie - "Secrets (Remix)" ft. Mariah the Scientist
Alex Porat - "HATELOVE"
Ana Mena & Natalia Lacunza - "Me He Pillao x Ti"
Anne-Marie - "SAD B!TCH (Acoustic)"
Ashley McBryde - "Light On In The Kitchen"
Brad Paisley - "Same Here" ft. Володимир Зеленський (Volodymyr Zelensky)
BROODS - "Fuck My Money"
Chlöe - "How Does It Feel" ft. Chris Brown
CHVRCHES - "OVER"
DDG - "Way Too Petty"
Colton Dixon - "My Light"
Dionne Warwick & Dolly Parton - "Peace Like A River"
Dreamer Isioma - "Technicolor Love" ft. redveil
Em Beihold - "Roller Coasters Make Me Sad"
EST Gee - "Undefeated"
EZVIT 810 - "Tenerte Cerca"
G Herbo & Murda Beatz - "Raining" ft. Yung Bleu
Grace Carter - "Pick Your Tears Up"
Halsey - "Die 4 Me"
陳柏宇 (Jason Chan) - "一人傍晚藝術館 (Evening Alone At Art Gallery)"
Imanbek & Trevor Daniel - "In The Morning"
Ingrid Andress - "Treated Me Good"
Jim Jones, Hitmaka & Stefflon Don - "I Am"
Jonas Brothers - "Wings"
Justin Moore - "Stray Dogs"
Kidz Bop Kids - "Made You Look"
Knightlight - "Gave U Hell" ft. madelaine
Lil Pump & Smokepurpp - "Tesla"
Lil Mabu - "TRIP TO THE HOOD"
Loud Luxury - "Next To You" ft. Kane Brown
Luke Combs - "Joe"
Matt Citron - "Dirty World"
Miranda​! & Emilia - "Uno Los Dos"
MoStack - "The Weekend"
Mvros & Khaled – "Ocupada"
Nanu - "Hembra Doma Machos"
NLE Choppa - "Ain't Gonna Answer" ft. Lil Wayne
Rich The Kid - "Do You Love Me?" ft. Lil Tjay
Russ Millions - "Dancer" ft. Noizy, Rondodasosa & Capo Plaza
Sam Fischer & Amy Shark - "High On You"
Stormzy - "Hide & Seek (Rema Remix)" ft. Rema
The Kid LAROI - "I GUESS IT'S LOVE?"
The Weeknd & Ariana Grande - "Die For You (Remix)"
Victoria Nadine - "Saw It Coming"
Yot Club - "saturday"
Zack Bia - "One Of Those Days" ft. Lil Yachty & 347aidan
2/25
DAGames - "I'll Make Them Whole"
Matt Citron - "Daydream Coastin"
Now United - "Love Myself"
2/26
Matt Citron - "The Long Way Home"
2/27
Matt Citron - "On Backs of Cars"
2/28
Jer 柳應廷 - "從零開始的新世界 (Starting From Zero)"
Matt Citron - "Howlin"
Now United - "