
1 ContributorNew Music Friday Christian 05/01/20 Lyricsfor KING & COUNTRY - TOGETHER (feat. Tori Kelly, Kirk Franklin)
Hillsong UNITED - Another In The Fire (Studio) (feat. TAYA)
Steven Curtis Chapman - Together (We'll Get Through This) (feat. Brad Paisley, Tasha Cobbs Leonard, Lauren Alaina)
Elevation Worship - Never Lost (Live) (feat. Tauren Wells)
Housefires - Breathe Again (Live) (feat. Chandler Moore, Nate Moore)
Jordan Feliz - Glorify
TobyMac - See The Light (Radio Version)
Ryan Stevenson - Wildest Dreams
NEEDTOBREATHE - Hang On
Ty Brasel - Paid For It (feat. Jay-Way, Brianna Catrice)
Rita Springer - Landslide
Jillian Edwards - But I Know You
Vineyard Worship - Sons and Daughters (feat. Kyle Howard)
Citizens - All I Need
Caitie Hurst - Yours
Local Sound - Never Far (House Church)
JJ Heller - Always
Meredith Andrews - A Million Saints (Orchestral Version)
CalledOut Music - Already Won
** Ricky Dillard - God's Gonna Do It (Live)
Leanna Crawford - Mean Girls
planetboom - Jesus Is The Key
Byron Juane - Afraid (feat. Danielle Apicella)
** Roy Tosh - Close (feat. Evan & Eris) (Remix) (feat. GIDI)
Mission - Work For It (feat. BrvndonP)
** Laity - Eternally
John Tibbs - Because He Lives
Brian Ortize - Way Maker
Jarrad Ricketts - You Are Lord
Seth Fowler - Crown You
Rapzilla - Better Me (feat. Double Atl)
1K Phew - Outside (feat. 1k Pson)
K-Ross - Trying
Keyla Richardson - Corona Can't Hold Me Down
Demarcus Kelly - Forever
Noah Cleveland - The Father's House
The LeFevre Quartet - Bigger Boat
Micah Tyler - Love Lifted Me Up
Jonathan McReynolds - Grace
Jesus Culture - Revival (Live) (feat. Chris McClarney)
Chris Renzema - God Is Love
Rodney "Darkchild" Jerkins - Come Together (feat. Tim Bowman Jr, Joy Enriquez, Kirk Franklin, Kelontae Gavin, Fred Hammond, Heavenly Joy, Le'Andria Johnson, Lecrae, Mary Mary, Jac Ross, Marvin Sapp, Karen Clark Sheard, Kierra Sheard, Shelby 5)
We The Kingdom - Don't Tread On Me
Mosaic MSC - Dreams (Live)
Audrey Assad - Find You
Rachel Wammack - When I Say Amen
Jon Guerra - Hiding Lord
Amanda Lindsey Cook - Help Is on the Way
Hillsong Worship - Awake My Soul (Live)
Tye Tribbett - We Gon’ Be Alright
Wande - WAKANDE
Josh Wilson - Revolutionary
SEU Worship - A Thousand Generations (feat. Dan Rivera)
River Valley Worship - All of Me
Local Sound - Heartache (House Church)
Tori Harper - The Wreck
John Tibbs - Great Is Thy Faithfulness
Sarah Kroger - Standing In Your Light
Vineyard Worship - We Shine (feat. Kat Regester, David Plumb)
** Sajan Nauriyal - trust (feat. CASS)
** Murs - How Great (feat. Dee-1, Horace C. Bowers)
Bizzle - Who's the Man (feat. J.R.)
** Kamban - Art of Flow (feat. Bl1nd3d, Rapzilla, Steven Malcolm)
Relient K - High of 75 (Live at The Ritz, Raleigh, NC - 10/29/16)
LIFE Worship - This Is Not the End (Live)
** Laity - YLIOF
Carrollton - Not Afraid Of The Dark
Switchfoot - JOY INVINCIBLE (Feat. Jenn Johnson)
Wande - Be The Light (feat. Evan and Eris)
** Kierra Sheard - Something Has To Break (Live) (feat. Tasha Cobbs Leonard)
Housefires - I’ll Give Thanks (feat. Kirby Kaple)
Vertical Worship - Faithful Now (Single Version)
Local Sound - On My Side (House Church)
Influence Music - Prophesy (Live) (feat. Melody Noel)
Corey Voss - Let There Be Wonder (Live) (feat. Madison Street Worship)
Grace City - The Same (feat. Michael Delgado, Kari Drolshagen)
Danny Gokey - Love God Love People (Radio Version)
Chris August - Gave You My Heart
KB - Armies
Alive City - Candid Heart
** Sidewalk Prophets - Don’t Sweat It
Futures - I'm Yours
Jon Guerra - Hold On
Newsboys - Love One Another (Live)
L. Spenser Smith - Changed My Song
Joshua Luke Smith - Meaningless
Thi'sl - Until Tomorrow
Jenna Wright - Feels Like Home
Jason Crabb - When I Turn to You
John Tibbs - It Is Well
Trinity (NL) - May You Have (feat. Maria Solheim)
** Laity - Close to You
Life Center Worship - Overwhelmed
Benita Jones - Still Everything (Live)
Bright City - Not Going Back (Live)
Maverick City Music - Man of Your Word (feat. Chandler Moore, KJ Scriven)
Ernie Haase & Signature Sound - Then Came The Morning
John Newton - Amazing Grace (Arr. William Ross) (feat. Andrea Bocelli, Czech National Symphony 