

For September 2021 album releases, visit this page

This page highlights all singles released in every genre of Christian music… Read More 9/1Clayton Hackett - "Breath (MAKR Remix)" feat. Jacob Rhodes
Poor Bishop Hooper - "Psalm 88"9/3Abby Robertson - "Little Bit More (Neon Feather Remix)" feat. Neon Feather*
Alabaster Co. - "Love" feat. Marcus Ramsay, Imer Santiago & Shawn Halim
Anna Waters - "Deep"*
BEACH W - "simple"
Ben Lawrence - "i hope you're good"
Bernardo Basso & Edu Linares - "Stronger"*
BigBreeze - "Holy Stiff" feat. Parris Chariz*
Bjéar - "Hymn (Lifted)"*
Buisi Nwade - "The Lord Is Great"*
Caleb Gordon - "Timmy Turner"*
Caleb McCoy - "Keep Your Word" feat. Mariah Anae*
Caleb Stanton - "Like It Did"*
Canyon Hills Worship - "Spirit Of God (Live)"*
Canyon Hills Worship - "Spirit Of God (Live / Radio Edit)"*
Caroline Cobb - "Find Rest (Matthew 11)" feat. Taylor Leonhardt*
CalledOut Music - "Shout to the Lord"*
CANDIACE - "Benefits"*
Chanté Moore - "Right One"*
Chasen - "I'm So Grateful" feat. Matt Hammitt*
Christian Anthony Liang - "This Is My Father's World"*
Christian Singleton - "All Yours" feat. Isaias Baquedano
City of Auburn - "Off the Block"
Darla Baltazar - "unsettle me. (demo)"
Darius Twyman & Destiny - "Tell Me Where"*
David Michael Wyatt - "Hydration (DMW Edition)"
David Phelps - "I Remember What We Thought Love Was"*
DeAnte Duckett & The Justified Crew - "I've Gotta Praise The Lord (Radio Edit)" feat. Vanessa Grundy*
DJ Promote & Swoope - "Good Day"*
Drew Poole - "Hurricane"
Eagle Brook Music - "We Believe"*
Elias Dummer - "The Gospel is Rest" feat. Land of Color
Empty - "TEMPORARY HIGH"
GabrielRodriguezEMC, Musiko & Jay Kalyl - "Energía (Remix)"*
Gateway Youth - "Better To Come"*
Glowing Moses - "Ghosts"*
Hinge Point - "Living Water"*
Hyper Fenton & Jason Fenton - "How I Feel"*
Isaiah 6tyOne - "Your Kingdom Come (The Shadow of God's Kingdom)"*
Jay White - "Mother"*
Jekalyn Carr - "My Portion"*
Jervis Campbell - "You Have My Heart"*
JJ Heller - "I See You"
Joe Garza - "Dry Bones"
Johnny Knox - "September in San Clemente"*
John Ward - "Egypt (Acoustic)"*
John Ward - "Pride Is the Devil (Acoustic)"*
Josh Villegas - "Sun Love"*
Jude Barclay & Synth Vibes - "What If Remix"*
K-SEE - "Let Us Rage"*
LIFE UNLTD - "Fresh Fire (Live)"*
LLC Flame - "Hard Times Remix" feat. Parris Chariz
Mac Powell - "Everlasting Arms"*
Madison Ryann Ward - "WANDA"*
Matt & Christy Taylor & The Wilds - "Gentle Savior"*
Matt Maher - "Joyful Noise" feat. DOE*
Mike Myz - "For This"* feat. Kurtis Hoppie
Mitchelle Santiago - "Oh Dear"*
Montell Fish - "Can't Get Enough"*
Natalie Cleveland - "Work To Do"*
Nate Gardiner - "Your Name"*
NIRVA - "All That's Within Me"*
Noah Paul Harrison - "Aren't We Something"
Nu Tone - "Real Love" feat. 3 Miles High*
Paul Whitacre - "90 down 40"*
Paul Wilbur - "O Yah"*
River Valley Worship - "Fill Me"*
River Valley Worship - "Sanctuary"
Saint James, Lundi & Scootie Wop - "Keep Me In Mind"*
Sera Noa - "Author Of My Life"*
Sojourn Music - "Take Heart"*
Stephanie Summers - "Mighty Strong God" feat. JJ Hairston*
Stephen McWhirter & Jason Clayborn - "Highest Praise (We Lift You)"
Stored in my Heart - "A Precious Hope for Wand'ring Sheep"*
Tasha Cobbs Leonard - "Lift Every Voice And Sing"*
Taylor Armstrong - "Kills Me"
The August Guns - "Victories"*
The Belonging Co - "La Victoria" feat. Danny Gokey*
The Collective KC - "You Are Good" feat. Andrew Pickens & TRIISH*
The Old Paths - "How Good The Good News Feels"*
This Surrender - "Is He Worthy"*
TIMŌRĀTUS - "We Made It"*
Tommy Payne - "New Creation"*
UPPERROOM - "Give Me Jesus"
Walnut Creek Church - "Final Sacrifice (Demo)"*
Weathered - "Work it Out" feat. Zeek Power
West of Here - "Mortals"*
Yung Drew - "Global" feat. Miles Minnick*
5ive - "All My Life"*9/8Andy Mineo - "Nobody's Coming"
Charlie Powers - "Alone With Myself"*
Poor Bishop Hooper - "Psalm 89"9/10Abby Robertson & Neon Feather - "Sanctuary (Neon Feather Remix)"*
Alexander Pappas - "A BEAUTIFUL LIFE"
Alvin Cedric - "Carry On" feat. Aria Alise
Bethel Music - "Homecoming (Live)" feat. Cory Asbury & Gable Price
Brandon Camphor & One Way - "Celebrate"
Brandon Lake & Jenn Johnson - "Too Good To Not Believe (Radio Version)"*
CE - "Oh Spirit"*
CeCe Winans - "Believe For It" feat. Lauren Daigle
Chris Tomlin - "Emmanuel God With Us (Live)"*
Coby James - "Brand New (Alternative Version)"*
Corey Wise - "I Might Not Be Breathing" feat. OnBeatMusic*
CRYS - "Ahí Estás Tú" feat. Tommy Royale*
Darla Baltazar - "apologetic. (demo)"
Dee Wilson & Sharon Irving - "O Spirit"*
Eagle Brook Music - "We Believe"*
Emissary - "Yours"*
Faithlife Music - "In the Air" feat. James David William & Krystle Best*
Francesca Battistelli - "God Is Good"
Grace City - "Holy, Holy / Santo, Santo" feat. Evan Craft*
Grace Graber - "The Life"*
Gwil Davey & Matias Ruiz - "Arise (Matias Ruiz Remix)"*
Hillsong Young & Free - "As I Am" feat. Peter CottonTale
Honor & Glory - "God Of My Story"*
Jodi Essex - "Offend"*
Jonathan Lawes - "Control" feat. Sarah Nathalié & J.R*
Jonathan Traylor - "High Up"
Jonny Hayes - "I Won't Let You Go"*
Jordan St. Cyr - "Weary Traveler"
JUDAH. & John Van Deusen - "He Is Good"
KB - "Worship in the Moshpit"
Keith and Kristyn Getty - "It Is Well With My Soul"*
Kingdom Culture Worship - "Wind of Heaven"*
Kinnship & Pablo Nouvelle - "The Wholesomeness of Waiting"*
Lion of Judah - "Lifeline"
Loren Mulraine - "Sanctified"*
Mark Barlow - "Tenderness"
Maverick City Musica & Maverick City Music - "Nadie Como Tú" feat. Aaron Moses, Israel Houghton & Adrienne Houghton*
Mirours - "Parallax"
Myke Grizzly - "SAD"*
Nissim Black & Shiah Maisel - "Hope"*
Patrick McMillan & Xay Hill - "Never Change"*
Pyramid Park - "Run"*
Richlin - "King on the Inside"
solae, Dâmares Gomes & Amen Worldwide - "Steadfast Love"*
Soul Survivor - "Hope Arising"*
Switch - "Good Friend"
Tay Collier - "Banner" feat. Zay Jones & Torey D'Shaun*
Tayler Kerzmann & Caleb Lockwood - "Not Alone"*
The Agape Music Group - "Fire + Rain" feat. Renee Pullum*
The Color - "Stranger"*
The Gray Havens - "Tread The Dawn"
The Rance Allen Group - "Love Makes The World Go Around (Radio Edit)"*
The Talleys - "Testify (Live)"*
Travis Ryan - "Praise the King Eternal"*
United Pursuit - "Bed of Humility"
We Are Messengers & Cory Asbury - "Come What May +"*
We Are Messengers & Cory Asbury - "Come What May (Acoustic) +"*
We The Kingdom - "Dancing On The Waves (Radio Version)"*
Wilder Adkins - "The Last Ones Shall Be First"*9/15Poor Bishop Hooper - "Psalm 90"
Skillet - "Surviving The Game"9/16Zach Winters - "There for You"9/17Akesse Brempong - "Victory" feat. Johnny Haick*
Andy Perez - "Shoot" feat. Christopher Syncere*
Angie Rose - "Freedom (Remix)" feat. Kingdmusic*
Asha Elia - "Grow High"
Battz - "Spare A Dollar"*
Bethel Music - "I Believe (Live)" feat. Jonathan David & Melissa Helser
BigBreeze & TJ Carroll - "SOMEHOW"*
BigGucciDame - "No Lean" feat Not Klyde*
Brady James - "TRY YOU"
Brian Emanuel, Ilish & David Onetime - "Así Soy Yo"*
Caleb and Kelsey - "So Well"*
Celtic Worship - "Because He Lives"*
DeLaura Puckett - "Go"*
Ethan Nathaniel - "Break My Heart" feat. Emily Sage*
Gaither Vocal Band - "The Manger And The Cross"*
Gary LeVox - "Working On Sunday"*
gloryfall - "New Beginnings"*
Holly Starr - "Daylight"
Hunterdrinkswater - "HER"*
India Dupriez - "Pray"*
Jay Kalyl - "Influencer"*
Jet Trouble - "Far Away"
John Mark McMillan - "Juggernaut (Sessions)" feat. Ben Rector
Jonathan McReynolds & Mali Music - "Adulting (Live)"*
Jon Foreman - "Jesus, I Have My Doubts (Live)"
JSteph - "Get This Right" feat. Nitro X*
Katie Lighty - "Never"*
King Chav & Derek Minor - "Fresh" feat. Ebonique*
Kmo - "The Garden"*
Lucinda Moore - "Lord, I Hear You"*
Many Cities - "Kaleo"*
Marie Love & Faith Lofi - "prove it"
Martin Smith - "Trouble" feat. The Kingdom Choir
Maryanne J. George - "Not Just Stories" feat. Aaron Moses*
Matthew Parker - "Signal"
Micah Stampley - "Come See (Radio Edit)"*
Mike Teezy - "Big Problem" feat. Mission*
Moriah - "Known, Seen, Loved"
Newsboys - "Clean"
NewSpring Worship - "I Trust You"*
Raw-B - "HELP" feat. PENLEY*
Rebecca Lauren - "Foundations"*
Ricky Dillard - "All Of My Help (Live)"*
Ryan Ellis & Essential Worship - "Keep My Eyes Up (Song Session)"
Shola OG - "96 Chambers"*
Simple Hymns - "Confession Hymn" feat. Matt Weeks & Nicki Rogers*
Soul Survivor - "Hope Arising"*
Spencer Annis & Ben Potter - "Grace Like Yours Pt. II"
The Cashmans - "Burn (Radio Version)"*
The Hoppers - "Can You See The Clock"*
The Lore Family - "The World Needs a Song"*
The Nelons - "Grace Ain't Fair (Acoustic Version)"*
TobyMac - "Promised Land"
We Are Messengers - "Friend Of Sinners"
Xander Sallows - "DYSFUNCTIONAL"*
Zach Winters - "There for You"*9/22Poor Bishop Hooper - "Psalm 91"9/24Aaron Cole - "LEAVE ME" feat. J Moss
After Grace - "Like Daddy Did"*
Alvin Cedric - "Leaving" feat. HYLEM*
Antwan Jenkins - "I Will Wait (Live)" feat. Chris Bender*
Audacious Worship - "You Are"*
Ben Lawrence - "AVOCADOS"
Bishop Leonard Scott - "Great I Am" feat. Quinton Elliott*
Bowen Abel - "Wildflowers"*
Brandin Reed - "Heal My Heart (Live)"*
Brave Worship - "Wash Over Me" feat. Baily Hager*
Byron Juane - "Slyde" feat. JC*
Citipointe Worship - "Pavement (Live)"
Clemency - "Brave"*
Corey Wise - "Hard Times Don't Last"*
Covenant Worship - "Light Of The World"*
Darling We're Dancing We've Been Liberated - "Redeemed Rhythm"
Darling We're Dancing We've Been Liberated - "The Rescuer That Resurrects"
Emily Faith - "This Is Faith"*
Foothills Collective - "On That Sunday Morning (Reimagined)"*
for King & Country - "For God Is With Us"
Freewill - "Lifetime"*
Gaetan Judd - "trust in you"
Gateway Kids Worship - "Here With Me" feat. Zac Rowe
Gatton - "If I Had Stayed"*
Hollyn - "Mood Swings"
Ian Zumback - "Wasted Years (Live)"*
IMRSQD, Moflo Music & Sammie Lee - "lifetime"*
John Mark Pantana - "New Day" feat. Mark Barlow
John Waller - "Kingdom Symphony" feat. Hadlee Waller*
Jon Reddick - "In The Room"*
Kevin Quinn - "Fuego En Mi Interior"*
Kingdom Culture Worship - "Man by the River"*
Kirk Franklin - "Lean on Me" feat. The Compassion Youth Choir*
LVTE - "Free" feat. Brian McMaster & XII*
Mac Powell - "1991"*
Maranda Curtis - "Lazarus"*
Marcos Witt - "Viviré"*
Marie Love & Faith Lofi - "prove it (acoustic)"
Mark Barlow - "Face to Face"
Montell Fish - "Wings"
Muntjac - "Rain Clouds"*
Nu Tone - "Light Work" feat. Jay Steezy & A. Ruiz*
Out of the Dust - "Fall Back In Love"*
Paul Russell & Wes Walker - "Nose Job"*
Propaganda & L's - "Calibrate" feat. Jacob G & Sam Hackett*
Rachael Nemiroff - "I Could Sing Of Your Love Forever"*
Requiem Heist - "Raise a Glass"*
Reu - "Psalm 23"*
Riley Clemmons - "For The Good"
River Valley AGES - "Honest"
RNW Music - "Even When (Live)" feat. Justin Benson*
Roy Tosh - "Why Should I" feat. Quinten Coblentz
Sam Rivera - "Drive"
Selah - "One Name (Ek Naam)"*
Sensere - "Do It"*
Shane & Shane - "Great Is Thy Faithfulness" feat. Bethany Barnard*
Stephen Christian - "King of Impossible"*
Stephen Stanley - "The Heat"*
Tammy Rogers & Thomm Jutz - "I Surely Will Be Singing"*
Tatiana Manaois - "Your Turning Page"*
Tekoa - "Yahweh Elyon"*
Temitope - "Be The One (Reimagiend)" feat. David Leonard*
Torey D'Shaun - "This Ain't That"
Tweet - "Neva Gonna Break My Heart Again"*
UPPERROOM - "On The Altar" feat. Elyssa Smith
Vertical Worship - "House of the Lord"*
Village Lights - "Promised Land" feat. Ike Ndolo
War Of Ages - "Pyrite"
Yancy - "Every Victory"*
7 Hills Worship - "Good and Perfect"*9/25RICE Movement - "Living Water" feat. Eleanor Kaw, Jared Soh & Daniel 