

For April 2023 album releases, visit this page

This page highlights the notable singles released in all genres throughout April 2023. Each song… Read More 4/1
Clairo - "For Now"
4/2
BiSH - "​​innocent arrogance"
4/3
陳健安 (On Chan) - "繼續繼續 (​​on and on)"
Gryffin & Kid Joi - "Oceans"
Kiana Ledé - "Jealous" ft. Ella Mai
Mozzy - "FREE ALL THE LIFERS"
Mura Masa - "Whenever I Want"
SBTRKT - "Days Go By" ft. Toro y Moi
The Drums - "I Want It All"
陳慧敏 (Vivian Chan) - "十年如一日 (Ten Years As One Day)"
Vybz Kartel - "Come Sit Down"
Vybz Kartel - "Corrupt"
4/4
Daniel Caesar - "Unstoppable"
Marybeth Byrd - "People Pleaser"
Mikaela Davis - "Far From You"
Poppy - "Church Outfit"
Shygirl - "Playboy / Positions"
Wallice - "Best Friend"
Yaeji - "Passed Me By"
4/5
Alexander Stewart - "leave me in the dark"
Ben Harper - "Yard Sale" ft. Jack Johnson
Blondshell - "Salad"
Brevin Kim & OG Maco - "Walls"
Emily King - "False Start"
Little Dragon - "Slugs of Love"
Loren Gray - "Never Be Perfect"
Mahalia - "Terms and Conditions"
Oliver Heldens & Kylie Minogue - "10 Out Of 10"
Shenseea - "Locked Up Freestyle"
swim school - "​don't leave me behind"
Ten Tonnes - "Dancing, Alone"
Zak Abel - "Dance With You (The Comeback)"
4/6
Ashnikko - "WEEDKILLER"
Holding Absence - "A Crooked Melody"
Hotboy Wes - "Throw Dat"
Peter Gabriel - "i/o (Bright-Side Mix)"
UNKLFNKL & tan feelz - "Too Shy"
泳兒 (Vincy Chan) - "同歸於盡 (Ending Endlessly)"
4/7
Addison Grace - "WW3"
Alan Walker - "Dreamer"
Alesso & Ty Dolla $ign - "Caught A Body"
Alok - "Honor The Game (Honor Of Kings Theme Song)"
Aminé, KAYTRANADA & KAYTRAMINÉ - "4EVA" ft. Pharrell Williams
A R I Z O N A - "Dark Skies"
Ashley Kutcher - "I Can't Swim"
Astrid S - "Expiration Date_demo_V2.wav"
Bonnie Madison - "Figure It Out"
BoyWithUke - "Out Of Reach"
Calboy - "Stargaze"
CG5 - "Jump Around"
Chris Janson - "Tap That"
Col3trane - "Champagne Dial"
David Guetta, Anne-Marie & Coi Leray - "Baby Don't Hurt Me"
DDG - "This Summer"
Derivakat - "Eden"
Dorian Electra - "Freak Mode"
Drake - "Search & Rescue"
Emotional Oranges - "Be Somebody" ft. Tkay Maidza
Erica Banks - "Ain't Got Time"
Freya Ridings - "Perfect"
Greta Van Fleet - "Meeting The Master"
​iann dior - "10x3"
ILIRA - "Wishing Well"
Isak Danielson - "White Ferrari" ft. Alba August
Joey Bada$$ - "Fallin'"
John Newman - "Hold On To My Love"
Jonas Brothers - "Waffle House"
Joyner Lucas - "Blackout" ft. Future
JP Saxe - "I Don't Miss You"
Kodie Shane - "Outside the Lines"
KYLE & Tinashe - "Who's Taking You Home"
Labrinth - "Never Felt So Alone"
Leon Thomas - "Crash & Burn"
Leona Lewis - "One Step Closer"
Lil Yachty - "Strike (Holster)"
Maleah Frederick - "Space Out"
Noah Cyrus - "Everybody Needs Someone" ft. Vance Joy
Now United & R3HAB - "Run Till Dark (Carta & Willim Remix)"
Olivia O'Brien - "Born With A Broken Heart"
Only The Poets - "JUMP!"
Oscar Lang - "A Song About Me"
Pink Sweat$ - "Moments"
Ralph - "Scary Hot"
Rowan Drake - "Part of You"
Saadi Four & FCG Heem - "Destined"
Shordie Shordie & Kay Flock - "UK"
Skilla Baby - "Ok Bet"
Steve Aoki, Jimmie Allen & Dixie - "Older"
Surf - "Birkin"
The Paper Kites - "Till The Flame Turns Blue"
Vybz Kartel & ZJ Chrome - "Car Man"
YoungBoy Never Broke Again - "WTF" ft. Nicki Minaj
Yung Bleu - "Kissing On Your Tattoos"
4/11
Angel Olsen - "Forever Means"
Charlotte Cardin - "Confetti"
Girl Ray - "Hold Tight"
Kaiser Chiefs - "Jealousy"
LAUREL - "Change"
Mac Critter - "High Risk"
Patrick Wolf - "The Night Safari"
Romy - "Enjoy Your Life"
Spice - "Queen of the Dancehall"
STALEWHALE - "delusional"
The Hertz - "同性密友 (Bromance)"
The Linda Lindas - "Too Many Things"
Vistas - "Last Together"
4/12
Allen Stone - "Magic"
Dawn Richard - "Bubblegum"
李幸倪 (Gin Lee) - "單戀這件小事 (Trivial Matters of Us)"
陳卓賢 (Ian Chan) - "抱抱無尾熊 (Koala Cuddle)"
Lil Poppa - "Chrome Heart"
Meghan Trainor - "Mother (Radio Edit)"
Njomza - "Emotional"
Panchiko - "Portraits"
Rick Ross, Fat Joe & The LOX - "The Game"
Samia - "Country"
Samia - "Maps"
Sarah Klang - "Mercedes"
SHY Martin - "glued to the floor"
The National - "Your Mind Is Not Your Friend" ft. Phoebe Bridgers
The Tallest Man On Earth - "Looking for Love"
4/13
Alison Goldfrapp - "NeverStop"
Céline Dion - TBA
Jessie Ware - "Begin Again"
Jorja Smith - "Try Me"
Vybz Kartel & Skillibeng - "The King & The Prince"
4/14
AK - "You"
aldn & chloe moriondo - "pressure"
Alok & Solardo - "Over Again"
Arb-di - "Enjoy My Life"
Aziya - "atomic"
Baby Bugs - "Love Letters"
Burak Yeter, Harddope & Badscandal - "Low Lonely"
Busted - "Loser Kid 2.0" ft. Simple Plan
Busy Signal - "Forensic"
Brett Young - "Dance With You"
Calvin Harris & Ellie Goulding - "Miracle (Hardwell Remix)"
Charlie Puth - "That's Not How This Works (Sabrina’s Version)" ft. Dan + Shay & Sabrina Carpenter
Ciara - "Da Girls (Remix)" ft. Lola Brooke & Lady London
Corey Kent - "Something's Gonna Kill Me"
Demarco - "Walk Away"
Diplo, Sturgill Simpson, Dove Cameron & Johnny Blue Skies - "Use Me (Brutal Hearts)"
Doe Boy - "ROLL THE DICE" ft. DeJ Loaf
Dominic Fike - "Dancing In The Courthouse"
Dro Kenji - "ARSONIST"
Dubdogz, DJ Susan & CJ - "Smack That"
Fivio Foreign - "Hot Sauce"
for KING & COUNTRY, Jordin Sparks & R3HAB - "Love Me Like I Am (R3hab Remix)"
Hotboii - "WTF (Remix)" ft. Polo G
Ice Spice & Nicki Minaj- "Princess Diana (Remix)"
Jesy Nelson - "Bad Thing"
Joel Corry & Billen Ted - "Don't You Want Me Baby?" ft. Elphi
Jonas Blue & RANI - "Finally"
Josh Levi - "EGO"
謝安琪 (Kay Tse) - "晚安 (Good Night)"
陳慧琳 (Kelly Chen) - "我的親人 (Unconditional Love)"
Kelly Clarkson - "me"
Kelly Clarkson - "mine"
Lauren Spencer Smith - "Fantasy" ft. GAYLE & Em Beihold
Lewis Capaldi - "Wish You The Best"
Loser - "the office"
Mae Muller - "I Wrote A Song (Acoustic)"
Lyn Lapid - "poster boy"
Martin Jensen & Karen Harding - "Worship You"
Matchbox Twenty - "Wild Dogs (Running in a Slow Dream) "
Megan Moroney - "Girl in the Mirror"
New Hope Club - "Just Don't Know It Yet"
OhGeesy - "Chrome Hearted" ft. Tyga
per se - "最後一個糊塗神 (Memory Hero)"
Post Malone - "Chemical"
Rosse - "Coincidence"
Shenseea - "Curious"
Sheryl Crow - "Night Life"
Sigala, Mae Muller & Caity Baser - "Feels This Good (Acoustic)" ft. Stefflon Don
Taleban Dooda - "Mind Of A Maniac"
Tee Grizzley & Skilla Baby - "Dropped The Lo"
Teenage Bottlerocket - "So Dumb"
Timmy Trumpet & DVBBS - "Synergy"
Tobu & Wholm - "Better Days"
Tungevaag & Retrovision - "Alone With You"
Vacations - "Next Exit"
Vybz Kartel - "Money Chaser"
YoungBoy Never Broke Again & Mariah the Scientist - "Rear View"
Zoe Wees - "Don't Give Up"
4/15
6ix9ine - "WAPAE" ft. Bulin 47, Lenier & Angel Dior
4/17
BiC Fizzle - "Ride Fa Mine" ft. LG Malique
Byron Messia & Govana - "Stranger to Happiness"
Kevin Gates - "Do It Again"
MC 張天賦 (Cheung Tinfu) - "花海 (Floral Sea)"
Wiz Khalifa - "Why Not Not Why"
4/18
The Japanese House - "Sad to Breathe"
Valiant - "Insomnia"
4/19
Alkaline - "Motivation"
Arlo Parks - "Blades"
CG5 & Kortland James - "Peaches"
Daddy Yankee - "Gasolina (Safari Riot Remix)" ft. Myke Towers
Jodi Preston - "Not Myself
Lil Zay - "Deep End"
陳蕾 (Panther Chan) - "伸縮自如的愛 (Bungee Gum)"
Rita Ora - "Praising You" ft. Fatboy Slim
The Last Dinner Party - "Nothing Matters"
4/20
Anitta & HITMAKER - "Nu"
Bebe Rexha - "Satellite" ft. Snoop Dogg
CupcakKe's in the Microwave - "CVM"
DAAZ & Inner Circle - "LA PIPA DE LA PAZ"
DAGames - "Shot Down by the Mirror"
E-40 - "Front Row 40"
FamilyJules - "Ultraviolet"
Feid & Sean Paul - "Niña Bonita"
glaive - "i would pay to see them try"
glaive - "skinny white boy in that big black benz again"
張敬軒 (Hins Cheung) - "隱形遊樂場 (Imaginary Fairground)"
Jared Dines - "Fight to Survive"
Jonathan Young - "Ultraviolet"
Li Rye - "Switch"
Olamide & CKay - "Trumpet"
Peter Gabriel - "i/o (Dark-Side Mix)"
Prince Royce - "Me EnRD"
Shordie Shordie - "How High"
Tessellated & Vybz Kartel - "Girl Next Door"
Vybz Kartel - "Nuh Dweet"
Wande Coal - "Let Them Know"
Wisin & Anuel AA - "MI EXXX"
4/21
10:01 - "Flying Home"
AJR - "The Dumb Song"
Armani White - "SILVER TOOTH." ft. A$AP Ferg
Armin van Buuren & Vini Vici - "When We Come Alive"
BlueBucksClan - Supposed To"
Bobby Fishscale - "Really Eat"
Calboy - "Trippin Bout It"
Calvin Harris & Ellie Goulding - "Miracle (Mau P Remix)"
Colbie Caillat - "Worth It"
DDG - "I'm Geekin"
Ed Sheeran - "Boat"
Fizzle - "Sleep Paralysis"
Fizzle - "Sleep Paralysis (Radio Edit)"
Florence + the Machine - "Mermaids"
Georgia Ku - "Show Me Your Love"
Gurldoll - "Abyss"
Gus Dapperton & BENEE - "Don't Let Me Down"
Kim Petras - "Alone" ft. Nicki Minaj
Latto - "Put It On Da Floor"
Lizzie Esau - "Killer"
Luh Tyler - "First Show"
Matoma & James Droll - "Won't Follow You Home"
Masked Wolf - "Guidelines"
Moneybagg Yo - "Motion God"
Now United & R3HAB - "Run Till Dark (Arcando Remix)"
OhGeesy - "GEEALEAK (Remix)" ft. BIA
Old Dominion - "I Should Have Married You"
Onsight Deeda - "Don Dada"
RAYE - "Flip A Switch. (Remix)" ft. Coi Leray
Sigala, Mae Muller & Caity Baser - "Feels This Good (Extended)" ft. Stefflon Don
SOFI TUKKER - "Jacaré"
Tee Grizzley & Skilla Baby - "B&E Pt. 1"
Teejay & DJ Mac - "Drift"
The Chainsmokers & 347aidan - "Up & Down"
The Weeknd - "Double Fantasy" ft. Future
tuv - "daydream"
Vae Vanilla - "Its My Bday"
VIC MENSA - "$WISH" ft. G-Eazy & Chance the Rapper
Vybz Kartel & Likkle Addi - "Big Addi Likkle Addi"
4/22
Young King Slaton - "There's No Turning Back (Earth Day)"
4/23
Noah Thompson & HunterGirl - "One Day Tonight (Duet)"
4/24
雲浩影 (Cloud Wan) - "自發性神經反應 (Natural High)"
4/25
MC $oHo & KidNey - "橋橋 (Ideas)"
Thundercat & Tame Impala - "No More Lies"
4/26
ThxSoMch - "Crumbled"
4/27
boyband - "VISA FREESTYLE"
C-Kan & Gera MX - "La Misión (Episodio 1)"
Digga D & Latto - "Energy (Remix)"
Jason Derulo - "Glad U Came"
Miguel - "Give It To Me"
4/28
AK - "Numb"
Alok - "Mami Mami"
Bava - "Back to Me (Me Ma Moop)"
Bea Miller - "this call is coming from inside the house"
Busy Signal - "Lady In Red"
Chayce Beckham - "Till the Day I Die"
Chrissy Chlapecka - "Alpha"
Coi Leray - "Bops"
Coi Leray - "My Body"
Conor Maynard - "Storage"
Dallin Haymore - "Blue"
DaniLeigh - "Tasty"
Davina Michelle - "This Is My Life"
Drax Project - "Atmosphere"
Eighty8 - "Granny Baby"
Ellie Goulding & southstar - "By The End Of The Night (southstar Remix)"
‎‎‎glaive - "as if"
Imanbek & Def Leppard - "Pour Some Sugar On Me"
Jahmiel - "The Message"
Joel Corry & Billen Ted - "Do U Want Me Baby? (Sam Ryder Acoustic)"
Jonas Blue & RANI - "Finally (Endless Summer & Wave Wave Remix)"
Jordin Sparks - "Stop This Feeling (Frequency Pusher & PAYSO Remix)"
Kesha - "EAT THE ACID"
Kesha - "FINE LINE"
kkbutterfly27xx - "NANA"
Lola Brooke - "Just Relax"
Lonely Cortell - "enemy - remix" ft. vxncnt!
Lucy Loone - "Sugarcane"
Madilyn Mei - "Sleeping in the Kitchen" ft. Addison Grace
Mad Tsai - "in my head"
Mimi Webb - "Last Train To London (I Won't Look Back)"
Niall Horan - "Meltdown"
Nicky Romero - "Chapters"
R3HAB, INNA & Sash! - "Rock My Body"
Regard & Ella Henderson - "No Sleep (Drop G Remix)"
Ricki-Lee - "On My Own (Jolyon Petch Remix)"
RJAE - "Her Favorite Jhené Aiko Song"
Shouse & David Guetta - "Live Without Love"
Sonny Fodera, Paul Woolford & Ella Henderson - "Like I Used To"
Sudley - "fumble" ft. piri
林家謙 (Terence Lam) - "萬一你是個好人 (What If)"
Tom Speight - "Tomorrow"
XYLØ - "Super Sex Mona Lisa"
Yot Club - "mr. rager"
4/30
Caleb Hyles & Derivakat - "Without You"
Give Heart Productions - "Bye Bye Yesterday (From "Assassination Classroom")"
Matuê - "Conexões de Máfia" ft. Rich The 