

For December 2021 album releases, visit this page

This page highlights all singles released in every genre of Christian music… Read More 12/1Caleb Lockwood - "Hark!"*
Canon - "KNOCKED OUT"
Jimmy Cheo - "You Love Me, Lord (A Christmas Hymn) "*
Tim & The Glory Boys - "Bloodlines"*12/3After Grace - "Thank God For Christmas"*
aftrthght & qtsal - "waiting4u"*
Alvin Cedric - "Care" feat. CieMie*
AO1 Collective & Jeremiah Paltan - "Warm"*
Bria - "River Song"*
Casting Crowns - "Healer"
Chris McQuistion - "Washed By The Blood"*
Christian Singleton, Eva Swanson & Isaias Baquedano - "The One"*
City Light Worship - "Lamb of God (Live)" feat. Jr Aquino & Anna Golden*
Dan Bremnes - "Wouldn't Change A Thing"
Danielle Apicella - "Old Fashioned Christmas"*
Darla Baltazar - "SEARCH ME"
Dez Childs - "Open My Eyes"*
Griffo - "Ice Skates" fеat. LVTE*
Jazz Pierre - "Why Me"*
Jordan May - "Amazing Gracе"*
Josh Wright - "Lead The Way"*
Juice Bangers - "Seems Like" feat. Marty
Kendra Kay - "How Great Thou Art" feat. Jason Benoit*
Konola - "Red"*
Manafest - "I Run With Wolves"
Mark and Sarah Tillman - "Come Closer"*
Nathan Wagner - "The Antihero"*
Paul the Messenger - "Somebody Else (Edit)"*
Quiz Tha Great & Marizu - "Odo"*
Rachael Nemiroff - "Silent Night"*
Rehmahz & Kingdmusic - "Satisfy"*
REVERE - "There Is No Higher Name" feat. David Brymer & Laura Hackett Park*
Ricky Dillard - "Breakthrough (Live)" feat. D'Shondra*
Rob Ray - "Twilight"*
Ryan The Son - "Enough" feat. nobigdyl.
Sandra McCracken - "Everybody Hurts" feat. Liz Vice*
SEU Worship & Essential Worship - "Living Hope"*
Steven Malcolm - "Rooftop Freestyle" feat. Derek Minor
Tatiana Manois - "Muscle Memory"*
Tekoa & Rory Mckenna - "Rapids"*
The War Within - "Crisis Of Faith"*
Zack Limitless & Xay Hill - "No Time"*12/4WHATUPRG - "PRAISE!" feat. 1K Phew, 350, Aha Gazelle, Foggieraw, J. Monty, Kaleb Mitchell, NOT KLYDE, Parris Chariz & Ty Brasel12/9Seacoast Music - "Silent Night (Emmanuel)" feat. Brandon Lake*12/10Andy Cherry - "Auld Lang Syne"*
Bizzle & Kiddy Bizness - "Fill My Cup (Remix)"*
Caleb McCoy - "A Painting Of Peace" feat. Mariah Anae*
Cody Carnes - "Firm Foundation (He Won't)"
CRC Music - "Making Rivers (Remix)"*
Damara Melissa - "It Never Gets Old"*
Day One - "Goodness Of God" feat. Stephen McWhirter*
Dez Childs - "Open My Eyes"*
Dre Hughes - "Most Holy"*
Gray Robinson - "Day with Jesus"*
ISLY - "Wherever You May Go"
Jude Barclay - "another thursday night"
JXHN PVUL & Scootie Wop - "Nice n Slow"
Lacey Sturm - "Awaken Love"
Legin - "In Awe (Live Performance)" feat. The Last Take*
Lizzy Parra & Musiko - "Para Amarte"*
Mack Brock - "The Love of Jesus"
Phil Wickham - "Joy to the World (Joyful, Joyful) " feat. Jordan Feliz, The Bonner Family, Bryan & Katie Torwalt & Maverick City Music
Ricky Dillard - "He Won't Fail (Live)"*
Saddleback Worship - "Behold"
Sarah Nathalié - "All Year Long"*
Skillet - "Refuge"
Swaizy - "STURDY SANTA (Naughty Boy)"
The War Within - "Something To Say"*
The WRLDFMS Tony Williams & Chandler Moore - "Anymore"
Thi'sl - "Strange Things"*
Tre'Gadd - "WELCOME TO MY MOSHPIT!"
Trip Lee - "Supernatural"
Tylerhateslife & Coop - "Right Now"*
Vineyard Worship - "Angels We Have Heard On High (LoFi Christmas)" feat. Tiadra Mickels*
Xay Hill - "No Option" feat. Jekasole, Red Tips & Jack Tyler*
Young Heart - "MDYK (Maria Sabes Que)"*12/14Kieran the Light - "Ways"12/17Apex Frazier - "So Weak" feat. A3*
Ariel Tsai - "MY ALL IN ALL"*
Austin Joyce - "First Year"*
Bristol House - "Holy"*
CAIN - "The Commission (Band Version)"*
DANMAR - "Fargo" feat. Swaizy*
Eric Heron - "Skate" feat. Foggieraw
Gabby Callwood - "Gentiles"*
Jonathan Allen Wright - "Hear Me Out"*
Jude Barclay & Jeremiah Miller - "December"
Madison Ryann Ward - "Anchor"
Maranatha! Music - "Cornerstone"*
Memphis May Fire - "Left For Dead"
Mutemath - "Love Light a Way"
Nic D - "December"
Quasarpro - "Right Now"
RAY G & OnBeatMusic - "TVRNED UP" feat. JXHN PVUL
Ryan Vetter - "On My Side"*
Same OG & Oba Reengy - "Amazing Grace"*
Sam Jamz & Angeloh - "Drippin'"
Zambroa - "A Dove Captcha"*12/18Jem Pryse - "Turning Reality Into Dreams"*12/19Jason G Momin - "Surrender (God Who Cares)"*12/20nobigdyl. - "winter gettin colder"12/21seni. - "Solstice Baby"*12/22Abe Parker - "Rain For Christmas"*
Nissim Black - "Adored"*
Poor Bishop Hooper - "Psalm 104"*12/23HighPointe Worship - "Shout Your Name (Live)"*12/24Beach Chapel - "Stream"
Jude Barclay - "This Year"
Scootie Wop - "21"*
Sharp Dialect & IMRSQD - "Shiny Toys"*12/29Poor Bishop Hooper - "Psalm 105"*12/30Jordan May - "Over and Over"*12/31Battz - "2022"
Bro Ivory - "Praise The Lord So Hard" feat. Kieran the Light*
Bun B & Cory Mo - "Hesitate" feat. David Banner, Talib Kweli & Tobe Nwigwe
Daniel Doss - "Speaking Terms"*
CalledOut Music - "Thank You Lord"*
CRC Music - "Open The Gates"*
JJ Heller - "Growing Older"*
Jon Webster - "dizzy"*
Lynda Randle - "Plenty Good Room"*
Mitchell Tenpenny & Danny Gokey - "Bucket List"
Patrick McMillan & Xay Hill - "Alone"*
Ryan Clair Music - "What a Friend We Have in Jesus"*
Shane & Shane & Kingdom Kids - "Your Ways (Isaiah 55) "*
Shelby 5 - "Boom" feat. Lecrae
Worship and the Word & The Ineloquent - "Honor"
Xander Sallows, Sam Bowman & Sajan Nauriyal - "I GET 