

Oh, won't you stay for a while?
I'll take you on a ride if you can keep a secret


Stay a while, stay a while
And I will make it worth your while, worth your while
Stay a while, stay a while
And I'ma go the extra mile, extra mile
Boy, if you wait until the lights go down
I got some tricks that help you scream it out
So stay a while, stay a while
And I'ma make it worth your while, worth your while
(Oh, won't you stay for a while?)
See Tiësto LiveGet tickets as low as $75You might also like
(Oh, won't you stay for a while, for a while?)
(Oh, won't you stay for a while?)
(Oh, won't you stay for a while, for a while?)
Oh, won't you stay for a while?
I'll take you on a ride if you can keep a secret

For a 

There's a little devil in us all
Swear everybody in this town just wants to see you fall
Baby, it's no fun, so know it's just a game, yeah
Oh, keep running outta love
And I don't go giving up
When I'm running outta love, love
No, let's say I've had enough
And I don't go giving up
I said it all before

I ain't no millionaire, but I'm on my way
Can't find love, but hell, I'm on the way
When the world gets heavy, you might hear me say
I'm on my way, on my way, way
I ain't no millionaire, but I'm on my way
Can't find love, but hell, I'm on the way
When the world gets heavy, you might hear me say
I'm on my way, on my way, way
I ain't no millionaire, but I'm on my way
Can't find love, but hell, I'm on the way
When the world gets heavy, you might hear me say
I'm on my way, on my way, way
On my way, on way, way
I ain't no millionaire, but I'm on my way
Can't find love, but hell, I'm on the way
When the world gets heavy, you might hear me say
I'm on my way, on my way, way
I ain't no millionaire, but I'm on my way
Can't find love, but hell, I'm on the way
When the world gets heavy, you might hear me say
I'm on my way, on my way, waySee Tiësto LiveGet tickets as low as $75You might also 

For April 2022 album releases, visit this page

This page highlights the notable singles released in all genres throughout April 2022. Each song… Read More 4/1
5 Seconds of Summer - "Take My Hand"
71 Digits & Flo Rida - "Low"
A Boogie wit da Hoodie - "Playa" ft. Ella Bands
Álex Ubago - "Cuanto antes" ft. Lali
Alexander 23 - "Crash"
Alfie Templeman - "Leaving Today"
Alok & Bastille - "Run Into Trouble"
A$AP ANT & A$AP Rocky - "The God Hour"
Avila Brothers - "A Hard Working Man" ft. Snoop Dogg & Billy Ray Cyrus
AWOLNATION - "Material Girl" ft. Taylor Hanson
Black Birdie - "get over it"
Blasterjaxx - "Hurricane" ft. Prezioso
Blu DeTiger - "Hot Crush Lover"
BONES & ghost/\/ghoul - "Silverado"
Caitlyn Smith - "Dreamin's Free"
Call Me Karizma - "Young, In Love & Depressed AF"
Chris Brown - "WE (Warm Embrace)"
CHRIST DILLINGER - "A Reflection"
City Girls & Fivio Foreign - "Top Notch"
Col3trane - "Logan Paul"
DaBoyDame & Rick Ross - "Feelings" ft. EST Gee
Dave East - "Game 6 (East Mix)"
Dreezy - "They Not Ready"
呂爵安 (Edan Lui) - "Elevator"
ELIO - "Vitamins"
EMELINE - "cinderella's dead"
Fred De Palma & Justin Quiles - "ROMANCE"
Freddie Gibbs - "Ice Cream" ft. Rick Ross
Foals - "Looking High"
G Perico & Dave East - "Half A Bird"
Gavin James - "Circles"
Geowulf - "Drown"
Gryffin & OneRepublic - "You Were Loved"
Gucci Mane - "Blood All On It" ft. Young Dolph & Key Glock
Hardwell - "Into the Unknown"
Harry Styles - "As It Was"
Hotboii - "All I Know"
Isaac Dunbar - "Tainted Love"
Jaycoma & WILLSØFR3$H - "12 AM (Remix)"
Jenn Morel - "Tempo"
Jewel - "Living With Your Memory"
Joyner Lucas - "Ye Not Crazy"
Jubël - "So Sick"
Keith Urban - "Nightfalls"
Kiiara - "Microdose"
La Duraca - "LA VIDA"
Leven Kali - "LET IT RAIN"
Lil Eazzyy - "Nothing Left"
Lil Tjay - "In My Head"
Liam Gallagher - "C'mon You Know"
Llane & Omar Montes - "Sueño"
Lucki - "MEET ME THERE"
Lupe Fiasco - "100 Chicagos"
Martin Garrix & MESTO - "Limitless"
Masked Wolf & Bring Me The Horizon - "Fallout"
Matisse - "Un Nuevo Amor"
Matoma & A R I Z O N A - "Heart So Big"
Nascar Aloe - "IPA"
Natanael Cano - "Estrellas"
Never Broke Again - "Pull Up Actin" ft. YoungBoy Never Broke Again & P Yungin
Nightly - "hate my favorite band"
NLE Choppa - "Yak Flow"
Olivia O'Brien - "Bitches These Days"
Onlybino! - "Wya Freestyle"
Peces Raros & Trueno - "Cicuta (Remix)"
PGF Nuk - "Waddup (Remix)" ft. Polo G
Phabo - "Before I Let Her Go"
​ppcocaine - "Homie Hopper"
Rae Morris - "Running Shoes"
Rahky - "Get Out"
Sarah Close - "Gettin Older"
Slatt Zy - "Feel It In My Soul"
Sofía Blumer - "Solita en la Playa"
SOFI TUKKER - "Kakee"
SOG, Ryan Castro & Totoy El Frío - "La Nueva" ft. Blessd, Nath & Natan & Shander
Steele 11 - "THROW UP!"
Tee Grizzley - "Buss It All Down"
Thomas Rhett & Katy Perry - "Where We Started"
Tory Lanez - "Florida Shit"
Unlike Pluto - "Shelf Life"
Wiplash - "Ana"
Wiz Khalifa - "Iced Out Necklace"
Young M.A - "Tip the Surgeon"
Kanon, DJ.Silence - "Mavro Poiniko"
4/2
Summrs - "​bird allegiance"
4/3
Apethantos, Thitis - "BERSERK"
John Legend - "FREE"
Masicka - "History"
4/4
August Alsina - "Shake The World"
AURORA - "The Woman I Am"
BANKS - "Meteorite"
Jan Curious - "早晨 (Good Morning)" ft. 葛民輝 (Eric Kot)
J Arias - "Si Supieras"
Lil Darkie - "RUN"
MKULTRA - "It's About Time"
Rose Gray - "Last Song"
Santa Fe Klan - "Mar y Tierra"
Triple G - "Wonder"
​​vf7 & Lyanno - "Ya No Es ="
Wet Leg - "Ur Mum"
4/5
10Tik & Skillibeng - "Activate"
Anna Calvi - "Ain't No Grave"
Asian Doll - "Fell In Love"
CXRPSE - "LEASH"
DESTIN CONRAD & Kiana Ledé - "Unpredictable"
Doodie Lo - "FACE"
衛蘭 (Janice Vidal) - "風靡 (In The Wind)"
Juliana & Humbe - "Muchachitos"
L-Gante & DT.Bilardo - "SUSY 420"
Lizzy McAlpine - "hate to be lame" ft. FINNEAS
Mandy Moore - "Little Dreams"
Martin Garrix & Vluarr - "Reboot"
ScHoolboy Q - "Soccer Dad"
Taylor Bennett - "Fall Short"
TOPS - "Perfected Steps"
XANMAN$HAWTY & Bleachdiego - "Picture Perfect"
Wallice - "90s American Superstar"
4/6
Acid Souljah - "Captain Beefheart"
BANKS - "Deadend"
BRUHMANEGOD - "​oxygen"
Danntik & Santa RM - "A Mí"
DDG - "Whiskey Freestyle"
El Alfa, French Montana & Braulio Fogon - "Máquina de Dinero" ft. Kaly Ocho
Jalle & Issey Cross - "Downers"
Kris Floyd - "Cuentas Claras"
Lele Pons & Kim Loaiza - "Piketona"
Lil Gotit - "She Know It"
Melody's Echo Chamber - "Alma"
Netta - נטע - "I Love My Nails"
陳蕾 (Panther Chan) - "世界與你無關 (Embrace Yourself)"
Paulo Londra - "Chance"
Pusha T - "Neck & Wrist" ft. JAY-Z & Pharrell Williams
Rei & Mesita - "RAM PAM PAM"
Rolling Blackouts Coastal Fever - "My Echo"
RUGGERO - "YA FUE"
Stunna 4 Vegas - "M & M" ft. Sneezo Quixk & Ola Runt
Suki Waterhouse - "Wild Side"
wifisfuneral - "Honeybunz"
Wiz Khalifa, Big K.R.I.T. & Girl Talk - "Ain't No Fun"
WOS - "ARRANCÁRMELO"
4/7
Alicia Keys - "City of Gods (Part II)"
Alison Wonderland - "Forever"
Blessd - "Instagram"
CB - "Rap or Road"
Cian Ducrot - "All For You"
CNCO - "La Equivocada"
D.OZi - "Javy Báez 'El Mago'"
DJ Nelson, Jay Wheeler & Sammy Baby - "Loco Por Verte" ft. Alejandro Armes
Ethel Cain - "Strangers"
FKJ & Santana - "Greener"
​gizmo - "Flesh Made of Flaws"
iamamiwhoami - "canyon" ft. Lars Winnerbäck
Interpol - "Toni"
Jotaerre, KAROL G & Alejo - "Un Viaje" ft. Moffa
Kevin Roldán & DEKKO - "Perreito Under"
Khalil? - "LO NE LY"
KYSLINGO - "Cold Turkey"
Lefty Sm - "Original"
Lime Cordiale - "Facts of Life"
LIT killah, De La Ghetto & L-Gante - "KU'"
Mariah Angeliq - "Hey Siri"
Miranda Lambert - "Actin' Up"
Nickoog Clk - "En el Jacuzzi"
Nico Mastre, Brray & Cris Mj - "Beso de 3"
Oh Wonder - "Fuck It I Love You"
Ozuna & Boza - "Apretaito"
Revol & Darell - "Dónde Estás"
Skylar Grey - "Show Me Where It Hurts"
Soulja Boy - "Hold It Down"
Travie McCoy - "Stop It"
Vance Joy - "Clarity"
陳慧敏 (Vivian Chan) - "泰姬 (Taj)"
YOVNGCHIMI, Eladio Carrión & Hydro - "Glizzy Walk 2.5"
4/8
24kGoldn - "SCAR" ft. sokodomo
7xvethegenius - "Always Thank God" ft. Trae tha Truth
7xvethegenius - "Numbers"
Adri Torrón - "Háblame Claro"
Alice Merton - "Blindside"
Allison Ponthier - "Autopilot"
almost monday - "sunburn"
Ángela Aguilar - "Always On My Mind (Banda Sonora de la Serie Amsterdam)"
Animal Sun - "I'M ALREADY DEAD" ft. DREAMERS
Armin Van Buuren & Billen Ted - "Come Around Again" ft. JC Stewart
AUGUST 08 - "500 Days"
Awgust - "Boys Don't Cry"
BAD NEIGHBOR$ - "Vampire Diaries" ft. Lil Tracy
Bankrol Hayden - "Fuck Love"
Bankroll Freddie & Icewear Vezzo - "Pickin' Sides"
BIA - "LONDON" ft. J. Cole
BIGBABYGUCCI - "Outta State"
BigKayBeezy - "Misfit"
Big Yavo - "Cabbage Patch"
Bishop Briggs - "Art of Survival"
Bishop Briggs - "High Water"
Blackinny - "INTRO"
Blac Youngsta - "Can’t Spell"
Brett Young - "Long Way Home"
Cally Rhodes - "Life is Hard"
Camila Cabello - "psychofreak" ft. WILLOW
Carrie Underwood - "Denim & Rhinestones"
Charlie Puth - "That's Hilarious"
Charlotte Jane - "​10 percent"
Chenzo y Dezz & ElDiez10 - "Pa' Verte de Nuevo"
Chlöe - "Treat Me"
CORPSE - "POLTERGEIST!" ft. OmenXIII
Crissin - "Ácido"
DAGames, Saster - "Freaky Machine"
Dalmata, Totoy El Frio & PJ Sin Suela - "D.A.T.A."
Dani Barranco - "​cuando un te amo es triste"
David Guetta, Becky Hill & Ella Henderson - "Crazy What Love Can Do"
Doechii - "Crazy"
Drippin So Pretty - "Betrayed"
EDDISON & Afourteen - "Cullinan"
Eliza & The Delusionals - "Halloween"
Empress Of - "Save Me"
ericdoa - "lifeline"
FCG Heem - "Headlock" ft. Hotboii
Fousheé - "double standard"
Fran Mera - "Buchanan's"
G Perico - "It's Over"
Gente De Zona & Carlos Vives - "El Negrito"
George Cosby - "Paris"
Gonzy - "Uno Pal Otro"
Gracie Abrams - "Block me out"
Greta Isaac - "PAYRI$E"
Guapdad 4000 - "Black Iverson - A COLORS SHOW"
Hackle - "DUMBO" ft. Buckshot
Hanna Emilie - "Stay Numb"
Haywood - "Human to Fall Apart"
IDK - "Taco"
Imanbek & ​salem ilese - "Married to Your Melody"
陳凱詠 (Jace Chan) - "Long D"
Jack Harlow - "First Class"
Jack Johnson - "One Step Ahead"
Jim Jones, Lil Wayne & DJ Khaled - "We Set The Trends (Remix)" ft. Juelz Santana & Migos
J.I The Prince Of N.Y - "Toxic"
Kaien Cruz - "Anything U Want"
Karen Méndez & Juacko - "Fotos"
Kate Stewart - "Numb"
Kelsea Ballerini - "HEARTFIRST"
Kenyon Dixon - "Get High, Get By" ft. D Smoke
Koe Wetzel - "April Showers"
Lauv - "All 4 Nothing (I'm So In Love)"
LeAnn Rimes - "how much a heart can hold"
Lil Baby - "In A Minute"
Lil Baby - "Right On"
Lil Boom - "Yesterday"
Lil Dan & Brray - "Ella Quiere"
Lil Zay Osama - "Real Pain"
Lola Indigo - "Toy Story"
LØLØ - "Junkie"
Lostboycrow - "Chewed Up"
Maggie Rogers - "That's Where I Am"
Marty & Fernanda - "365"
Matteo Bocelli & Sebastián Yatra - "Tu Luz Quedó"
Maude Latour - "Lola"
Metteson - "Second Heart"
Mike Posner - "Home"
Milow - "How Love Works"
Navos & Galantis - "What It Feels Like" ft. YOU
Nickgeorge - "Joseando" ft. Alejo
NLE Choppa - "Sleazy Flow Freestyle"
NO1-NOAH - "Bonjour" ft. Summer Walker
Noah Cyrus - "I Burned LA Down"
Omar Courtz - "En Tu Cuerpo"
Pol Granch - "No Te Bastó, Mi Corazón"
Pollari - "4AM in Agoura"
Portion - "Eastside" ft. Toosii
Powfu - "draw you inside my book"
Prentiss - "​let myself go"
Rapeton Approved & Sael - "Del Mar"
Rexx Life Raj - "Jerry Curl" ft. Larry June
Rhys Lewis - "Alone"
Rocco Hunt, Omar Montes & Reik - "Solo quiero dedicarte"
Rowdy Rebel - "Rowdy vs Rebel"
Royal & the Serpent - "Happier In Hell"
Saak - "Delicuente"
Sasha Alex Sloan - "I Blame the World"
Scarlet Pleasure - "TO DIE FOR"
Sig.Carlito - "best :P"
Simple Plan - "Wake Me Up (When This Nightmare’s Over)"
SKAAR - "Get Him Away From Me"
Skylar Stecker - "What's Good" ft. Tone Stith
Slump6s - "Own It"
Spacey Jane - "It's Been a Long Day"
Spice, Demarco & Meeka - "Jiggle"
The Faim - "ERA"
The Knocks - "Bang Bang" ft. Donna Missal
TIMØ & Pitizion - "Canción de Amor"
Tyga - "Lifetime"
Unlike Pluto - "Have Fun"
will hyde - "​i always end up leaving."
Zelly Ocho - "Section 8"
ZHR - "Something Ain’t Right"
4/9
Tory Lanez - "Mucky James"
​wolfacejoeyy - "gi joe"
4/10
BasedNas - "China Vibez" ft. KA$HDAMI & Since99
L-Gante & Homer El Mero Mero - "Cementerio" ft. DT.Bilardo & Al Records
MKULTRA - "In My Toilet"
4/11
方皓玟 (Charmaine Fong) - "HW1"
EDDISON & CJ Hunter - "Go"
Little Big Town - "Hell Yeah"
Sig.Carlito - "i can die"
Uffie - "sophia"
4/12
100 gecs - "Doritos & Fritos"
Dear Jane - "脫骹的華爾茲 (Waltz Of The Damaged)"
EDDISON - "on go" ft. drownwithtoga
Five Finger Death Punch - "AfterLife"
Interpol - "Something Changed"
Jamie xx - "LET'S DO IT AGAIN"
Lil Pump - "All the Sudden"
Malucci - "3 y Pico"
Martin Garrix & Matisse and Sadko - "Good Morning"
Martin Lora & Arlene MC - "Tu No Cambia"
Matilda Mann - "Nice"
Muni Long - "Another"
paopao & iZaak - ​"¿qué nos pasó?"
ROBI - "Robot"
Tayc "D O D O (Adekunle Gold Version)" ft. Adekunle Gold
TOKiMONSTA & morgxn - "Loved By U"
wifisfuneral - "Let Me Fly"
4/13
Alfie Templeman - "Colour Me Blue"
Belle and Sebastian - "Young and Stupid"
Danny Beau - "text back"
Eix, Dalex & Juhn - "Tour (Remix)"
Faye Webster - "Car Therapy"
Gavin DeGraw - "Face the River"
Jeshi - "Protein" ft. Obongjayar
KHEA - "Young Flex"
Lil Pump - "All The Sudden"
MC 張天賦 - "小心地滑 (Caution Wet Floor)"
MØ - "New Moon (Remix)" ft. Rebecca Black
Mysie - "fade"
Ovi, Alemán & Noriel - "Ya Ni Sé"
Quando Rondo - "24"
Running Touch - "Why Do I"
Sig.Carlito - "imy2" ft. Zzz.
Squash - "Lattry"
Troye Sivan - "Angel Baby (Acoustic)"
Wet - "Where Did the Day Go"
Will Young - "Why Does It Hurt"
4/14
Afourteen - "PENIS MUSIC 2: TAKE 1"
Akemi Fox - "See You Soon"
Asan - "Frío Polar"
Big Soto - "Rosa"
boyband - "STOP IT!" ft. Billy Martin
CHRIST DILLINGER - "ME AND MADJAX GOT BEEF" ft. MADJAX
DEZ 余宗遙 - "綠洲 (Paradise)"
DJ Tao, Kaleb Di Masi & LIT killah - "De Lao a Lao: Turreo Sessions #5 (Remix)" ft. Alan Gomez, Javiielo & Omy De Oro
Duwap Kaine - "64/7"
ECKO - "Copacabana"
iamamiwhoami - "zeven"
Ibeyi & Jorja Smith - "Lavender & Roses (Champion Remix)"
Ir Sais - "Claramente"
Jake Bugg - "Seven Bridge Road"
Lauren Spencer-Smith - "Flowers"
Lizzo - "About Damn Time"
LocateEmilio - "tears"
Los Palmeras & Neo Pistea - "Macumbia"
Mallrat - "Surprise Me" ft. Azealia Banks
MC $oHo & KidNey - "夢想成真2022" ft. 譚仔女聲合唱團 (Tam Jai Women's Choir)
Mitch - "Shadeborough"
Ricky Martin & Reik - "A Veces Bien Y A Veces Mal"
Russ Millions - "Backseat"
Samantha Barrón & Leon Leiden - "Mala Vida"
Tomberlin - "sunstruck"
Train - "Running Back (Trying to Talk to You)"
Tunji Ige - "IMA ARTIST NOT a SOCIALITE"
Why Don't We - "Let Me Down Easy (Lie)"
Zion & Lennox & Revol - "Tus Labios"
4/15
6ix9ine - "GINÉ"
Aleyna Tilki - "Take it or Leave It"
Amelia Moore - "crybaby"
AronChupa & Flamingoz - "Coco Song"
AViVA - "SCREAM"
​ayokay - "If That's What You Need"
Benjamin Ingrosso - "Afterlife"
Benjamin Ingrosso - "Queens"
Big Yavo - "Yayski"
Blueface & G Herbo - "Street Signs"
BRUHMANEGOD - "the only song i ever drop that will sound like this"
CHASETHEMONEY & MVW - "99 Problems" ft. Valee & Babyface Ray
Clever - "Turn Out the Light"
Conan Gray - "Memories"
Craig David - "My Heart's Been Waiting For You" ft. Duvall
Cris Mj & Gotay "El Autentiko" - "Yo No Me Olvido"
DDG - "Ye Vs. Skete “Freestyle”"
Desiigner - "Topless"
Dev Lemons - "Autopilot"
Duke Deuce - "Running Out Of Love" ft. Dante Smith
Elisama - "Bajo"
Farina & Ryan Castro - "Fiesta"
Fátima Pinto - "Amor de Esos"
Fredo Bang & Roddy Ricch - "Last One Left"
gavn! - "Madelyne"
G Perico & Curren$y - "Bacc 2 The Blocc"
Gucci Mane - "Serial Killers"
HXLLYWOOD - "Don’t Matter" ft. Luh Kel & Toosii
Ingrid Andress - "Good Person"
Jade LeMac - "Aimed To Kill"
Jae Lynx - "Floss My Teeth"
Jeeiph - "CULPABLE"
Kay Flock, Cardi B & Dougie B - "Shake It" ft. Bory300
KESHORE - "Sweet"
Kill Jasper - "Better4U"
Kota The Friend - "Good Friday"
Lalo Ebratt, DEKKO & Yera - "Amor Con Odio"
Lil Boom - "Cloud’s Theme"
Lil Boom - "Mom Lovers Anthem"
Mak Sauce & Ray J - "Wish"
Maliibu Miitch - "Letter To My Ex"
Martin Garrix & DubVision - "Starlight (Keep Me Afloat)" ft. Shaun Farrugia
Max Frost - "Cool Kids"
MDMA - "Whitaker"
Morgan Wallen - "Don't Think Jesus"
Mt. Joy - "Orange Blood"
my little airport - "LUNCH"
Nascar Aloe - "TAKE OVER" ft. ​rirugiliyangugili & Yokai Jaki
Nevaeh Jolie - "Chew Me"
Night Lovell - "Mr. Make Her Dance"
Niko Moon - "EASY TONIGHT"
NoCap - "Very Special"
Otis Kane - "Free"
Phoebe Bridgers - "Sidelines"
Quin NFN - "ROKU"
Ransom - "Circumstances" ft. The Game
Reiley - "blah blah blah"
RHODES - "Suffering"
Richie Campbell - "Let You Go"
Robb Bank$ - "MAY I" ft. XXXTENTACION & Ski Mask the Slump God
Santana - "Yo Estaré" ft. Ally Brooke
Sheryl Crow - "Live With Me"
SosMula - "SNAP"
​SSGKobe - "REAL LIES"
Teddy Swims - "​dose"
Teejay - "​Different Species"
Tom Aspaul - "What Is Real Anymore?"
Trina & Latto - "Clap"
Tyga, Doja Cat & R3HAB - "Freaky Deaky (R3HAB Remix)"
Unlike Pluto - "Comatose Scenery"
Whethan - "COMPLICATED" ft. aldn & 8485
Willie Gomez - "Vicio"
4/16
DIFFERENT BRXXD - "Switchin' Lanes"
Jay Critch - "Spin No Blocks"
Since99 - "​​how will did chris"
4/18
Jackboy - "Pardon Me"
Jesse & Joy - "Clichés"
Kelis - "FEED THEM"
MKULTRA - "You Mean Nothing To Me"
吳保錡 (Poki Ng) - "猥瑣 (Obscene)"
Soulja Boy - "Blue Cheese"
4/19
BabyTron - "Type Shit"
easy life - "BEESWAX"
Fontaines D.C. - "Roman Holiday"
Hot Chip - "Down"
​nothing,nowhere. - "Memory Fracture"
​koi - "clearly"
Of Monsters and Men - "This Happiness"
Ravyn Lenae - "M.I.A."
Ruth Radelet - "Crimes"
YoSoyJenn - "Juntos Forever"
Young M.A - "Aye Day Pay Day"
Zola Jesus - "Desire"
Kanon - "No Limits"
4/20
AK4:20 & Brray - "MARIMBA GRINGA"
Alemán & L-Gante - "Requisito 420"
Bear's Den - "Frightened Whispers"
BIG30 -"King Of My Projects (Grizz Mix)"
Becky G - "NO MIENTEN"
Ben Carrillo & Amenazzy - "Marijuana"
Bill Wurtz - "at the corner store"
Blu Samu - "Amor"
BRS Kash - "Let Me In"
BRUHMANEGOD - "​​rampart"
C-Kan - "Toma 4"
Dani Ribba & Duki - "Lo Olvidaste"
Editors - "Heart Attack"
Florence + the Machine - "Free"
Gabbie Hanna - "Head in the Clouds"
Haiti Babii - "N.P.O" ft. Blueface
林海峰 (Jan Lamb) - "世間始終你好 (You Are The Sunshine Of My Life)"
Jer 柳應廷 - "離別的規矩 (Rules for Leaving)"
Josh Levi - "Vices"
KEVVO & Chucky73 - "Bancario"
Lykke Li - "HIGHWAY TO YOUR HEART"
Marcianeke & L-Gante - "Toma"
MORGAN - "In My Feelings"
Nick Mulvey - "Brother To You"
Nina Nesbitt - "Dinner Table"
Paradize & JonLee - "Pre Roll"
Purity Ring - "graves"
Rico Nasty - "Vaderz" ft. BKTHERULA
Rozzi - "Consequences" ft. Nile Rodgers
Sean Paul - "No Fear" ft. Damian Marley & Nicky Jam
Sinead O'Brien - "There Are Good Times Coming"
Slimelife Shawty - "Big Biznezz"
Soccer Mommy - "Unholy Affliction"
sophie meiers - "things will change"
Tank and the Bangas - "Oak Tree"
Tourist - "Avalanche"
泳兒 (Vincy Chan) - "早上37.2度 (Bloody Warmth)"
4/21
Chelsea Jade - "Best Behaviour"
Don Omar, Wisin & Gente de Zona - "Soy Yo"
Drippin So Pretty - "Fingertips"
EASYFUN - "Audio"
Eizander - "Pensándote"
Ethel Cain - "American Teenager"
Ha*Ash - "Mejor Que Te Acostumbres"
Hazel English - "Summer Nights"
iamamiwhoami - "i tenacious"
Jack Savoretti - "Dancing Through The Rain"
Jay Critch - "Stamped"
KAROL G - "PROVENZA"
Lefty Sm & La Santa Grifa - "Orgullo Café"
Leon Leiden & Adriel Favela - "Estamos Aquí"
Lil Poppa & Yo Gotti - "H Spot"
Lyanno - "Nasty"
M1llionz & Munna Duke - "10 TO DA O"
Monaleo & Flo Milli - "We Not Humping (Remix)"
NoCap - "Save The Day" ft. Kodak Black
Protoje - "HILLS"
Rels B - "No Sabe Igual"
Rosie Carney - "break the ground"
陳珊妮 (Sandee Chan) - "他說 (S/he Said)"
Shakira & Rauw Alejandro - "Te Felicito"
Sigrid & Bring Me The Horizon - "Bad Life"
​SSGKobe - "PILL POPPER"
Telenova - "Why Do I Keep You?"
Tommy Boysen - "SUDÁ" ft. Drago200
Triple G - "GIGGLE"
Yorke - "next life"
Yoss Bones & Toser One - "Nada Discreto"
4/22
$UICIDEBOY$ - "THE_EVIL_THAT_MEN_DO"
070 Shake - "Skin & Bones"
83HADES - "WTF" ft. Kamiyada+
88GLAM - "Happy Belated"
220 KID & ASDIS - "Release"
Ab-Soul - "Hollandaise"
AGNEZ MO - "Patience (Remix)" ft. D Smoke
Alejo & Lil Joujou - "Deja el misterio"
Alesso & Zara Larsson - "Words"
Alvaro Soler & Topic - "Solo Para Ti"
Arin Ray - "The Mood" ft. D Smoke
Acid Souljah - "Miss The Trap" ft. RXKNephew
Baby Queen - "Colours of You"
BabyTron - "Euphoria"
Bahari & Yoshi Flower - "Hot Mess"
Bella Dose - "Bite"
Bhavi - "Sienta Bien" ft. Laylow
Bow Anderson - "Mama Said"
Brevin Kim - "CAN'T HANDLE IT"
Brett Eldredge - "Songs About You"
Brother Leo - "Caroline"
Carmen DeLeon - "BBB"
Carrie Underwood - "Crazy Angels"
Casey Bishop - "Bad Dream"
Casey Veggies - "Royalty" ft. DOM KENNEDY
Cassia - "Not Enough Time to Think (Edit)"
Cheat Codes - "Tell Me You Love Me"
Christian Nodal - "Aguardiente"
Conor Maynard - "P.G.N.L."
Corina Smith - "Los Tweets"
CuteBad - "You Don't Really Wanna"
Daniel Caesar - "PLEASE DO NOT LEAN"
Desiigner - "420"
DreamDoll - "Ice Cream Dream" ft. French Montana
Dynoro, HVME & Gaudini - "Why Why Why"
Eagle-Eye Cherry - "Rising Sun"
Ed Sheeran - "2 Step (Remix)" ft. Lil Baby
EDDISON - "​cant nobody do it like me"
El Chulo - "Mala Actitud"
Eric Bellinger - "​Truly Yours (Remix)" ft. Phabo, The Game & DOM KENNEDY
Erica Banks - "Pop Out"
Ewan Mainwood - "No One Saving Me"
Fredo Bang & YNW Melly - "Brazy"
Futuristic - "I Don't Really Care"
Gareth Emery - "This Is Not the End" ft Roddy Woomble
George Ezra - "Green Green Grass"
GRANT - "Tilt"
Hey Violet - "Fall for Me First"
Isaac Dunbar - "Fool's Paradise"
Jade Novah - "Lost in You"
James Vincent McMorrow - "The Less I Knew"
Jay Critch - "Anyday"
Jayson Cash - "Top Down"
Johnny Orlando - "someone will love you better"
Jon Vinyl & Avry - "Favours"
Jorge Drexler - "Tinta y Tiempo"
José Madero - "Soy el Diluvio"
Josie Man - "by the end of the night"
JP Saxe - "A Little Bit Yours (Mandarin Version)" ft. 周興哲 (Eric Chou)
Juniper & Sango - "Tell Me"
Justine Skye - "What a Lie"
Kany García & Rozalén - "Justito a Tiempo"
Kid Ink & Verse Simmonds - "While We Dancing"
Kristiane - "Cry Baby"
KT Tunstall - "Resolution Song (United Kingdom)"
Lauren Aquilina - "Hanging by Your Halo"
Liam Gallagher - "Better Days"
Logic - "Decades"
Logic - "Tetris"
Los Ángeles Azules, Sofía Reyes & Esteman - "Esa Parte de Mí"
Luke Combs - "Tomorrow Me"
Luna Ki & Lola Indigo - "Piketaison"
Martin Garrix & Justin Mylo - "Find You" ft. Dewain Whitmore
Martin Jensen & FAST BOY - "One Day"
Matt Paris - "La Duda"
Megan Thee Stallion - "Plan B"
mehro - "parasite"
Monsieur Nov - "Ce que tu m'as fait"
Mosa Wild - "I Might Let You Down"
Nia Sultana - "In The Morning"
NLE Choppa - "Slut Me Out"
Noreh - "DCDT"
Ofenbach - "4U"
Olivera - "Repeat This Song"
Peter Nieto & Ivy Queen - "Pa'mi"
PinkPantheress - "Where You Are" ft. WILLOW
piri & Tommy Villiers - "​words"
PJ Morton - "Be Like Water" ft. Stevie Wonder & Nas
Pollari - "Runner!"
Roxette & Galantis - "Fading Like a Flower"
Ryan Castro, Justin Quiles & Symon Dice - "Mírate Bien"
Sara Kays - "Math"
Skip Marley - "Change"
Sobrino - "Nada Tuyo"
Sofía Hervier - "Lento"
Southside & Future - "Hold That Heat" ft. Travis Scott
Soy Emilia - "Sugar Daddy"
Sub Urban & BENEE - "UH OH!"
Tay Keith - "Lights Off" ft. Gunna & Lil Durk
The Chainsmokers - "Riptide"
The Kid LAROI - "Thousand Miles"
TiaCorine - "Gas Station"
TIEKS & MNEK - "The Funk"
Tom Speight - "You & I"
Tomine Harket - "Psychopath"
Tory Lanez - "I LIKE"
Unlike Pluto - "Crash and Burn"
​vf7 - "Llorando en Mex"
Vök - "Miss Confidence"
Warpaint - "Hips"
WESTSIDE BOOGIE & Shelley FKA DRAM - "AIGHT"
Zxmyr - "El Cholo y La Fresa"
4/23
Louie Ray - "Bar Louie"
4/24
EDDISON - "​​all i need"
Flume & QUIET BISON - "Escape" ft. KUČKA
Flume - "Palaces" ft. Damon Albarn
4/25
Alkaline - "Valum"
beabadoobee - "See you Soon"
Bizarrap & Paulo Londra - "Paulo Londra: Bzrp Music Sessions, Vol. 23"
Carlos Vives - "Solo"
洪嘉豪 (Hung Kaho) - "活人鏢靶 (The Dartboard)"
Jackboy - "Prize" ft. Lexxstasy
Lil Shordie Scott - "Rockin A Cardigan In Atlanta (Remix)" ft. Offset
Mars Argo - "Angry"
MIRROR - "Innerspace"
4/26
Alex Porat - "Pity Party"
Aluna & Jayda G - "Mine O' Mine"
BIGBABYGUCCI - "No Smoke"
Edén Muñoz - "Te Voy a Encontrar"
Elsa y Elmar - "vuelve"
Faye Webster - "Suite: Jonny"
Hozwal & El Clooy - "Cuéntale"
Lil Gotit - "Rich Shit" ft. Ty Dolla $ign & Lil Keed
Mandy Moore - "Four Moons"
Martin Garrix & Blinders - "Aurora"
ODESZA - "Behind the Sun"
PGF Nuk - "4PF"
Sin Bandera - "Cuando Te Vuelva a Ver"
Since99 - "Applying the pressure"
Young Nudy & BabyDrill - "Duntsane"
4/27
Akuna, El Cherry Scom & Leo RD - "BICHO"
Angel Olsen - "Big Time"
Arcade Fire - "Unconditional I (Lookout Kid)"
Asian Doll - "Talk Facts"
Big Jade - "Lower"
BRUHMANEGOD - "cleric beat"
Daniela Darcourt & Tito Nieves - "No Me Lo Creo"
Emilee - "Hida's House"
Fonseca & Matisse - "Pasa"
Ibeyi - "Rise Above"
Ivana - "Recuerdos Que Torturan"
馮允謙 (Jay Fung) - "Freakin' Nightmare"
Justin Bieber - "I Feel Funny"
Kris Floyd - "C100EN"
La Gabi - "KARMA"
Lolo Zouaï - "Give Me a Kiss"
Madeon - "Love You Back"
Mahalia - "In The Club"
mxmtoon - "victim of nostalgia"
per se - "竊竊詩 (The Prophet)"
ROBI, Dalex & Eix - "3 Deseos (Remix)" ft. Alejo
Röyksopp - "If You Want Me" ft. Susanne Sundfør
Sampa The Great - "Lane" ft. Denzel Curry
Superorganism - "​​​​crushed.zip"
The Black Keys - "It Ain't Over"
The Lumineers - "just like heaven"
Zolita - "I Fucking Love You"
4/28
Alex Mali - "Clearly"
Andrez Babii - "123 Enemies"
Ava Max - "Maybe You're the Problem"
Carlos Rivera - "Eres Tú (Mamá)"
Dímelo Flow, Reik & Jay Wheeler - "Winnie Pooh" ft. Boza
ella jane - "Time On"
​fl.vco - "​no more colors"
Gloria Trevi - "Él Se Equivocó"
Gotay "El Autentiko" - "Beneficio"
Gusi & Nacho - "Te Robaré"
HotSpanish - "Ella"
Ingratax - "APAGAITA"
Jon Z & Jory Boy - "Corazón de Hielo"
Kent Jamz - "Rollin’ Wit The Homies" ft. Buddy
Kevin Gates - "Big Lyfe"
Las Villa - "La Carta"
Lexi Jayde - "self sabotage"
Luck Ra & Rusherking - "Te Mentiría Remix"
Macaco & Ana Mena - "La Guerra de los Besos" ft. Bejo
Marca MP & Becky G - "Ya acabó"
Metric - "All Comes Crashing"
MUNA - "Kind of Girl"
Piso 21 & Santa Fe Klan - "Equivocado"
Robledo & Abraham Mateo - "Tu Me Querías (Remix)"
Sam Smith - "Love Me More"
Sia - "Manchild"
Snakehips - "WATER." ft. Bryce Vine
Tegan and Sara - "Fucking Up What Matters"
Valley - "CHAMPAGNE"
Yuridia - "Y Tú, ¿Qué Ganas?"
Zakhar - "Lights Out"
Zion & Lennox & Danny Ocean - "Brisa"
Kanon - "Dobermann"
4/29
3Breezy & Toosii - "Gangsta Wit It (Pt. 2)"
Aazar - "The Carnival" ft. French Montana, Mariah Angeliq, Zaac & Dany Synthé
Aina Maro, Leslie Shaw & Blue Mary - "No Vale la Pena"
Alan Walker - "The Drum"
Anson Seabra - "Peter Pan Was Right"
Antonio Orozco & Sebastián Yatra - "Entre Sobras y Sobras Me Faltas"
Arizona Zervas - "EVER AGAIN"
Babi - "Flores"
Baby Tate - "Dancing Queen"
Baby Tate - "Yasss Queen"
Benson Boone - "In the Stars"
BFB Da Packman - "Lost With Miami"
BigKayBeezy - "Southside"
Bobby Shmurda - "They Don't Know"
Calum Scott - "Heaven"
Carla Morrison - "Diamantes"
Chimbala & Tony Brey - "Banda"
Clean Bandit & Darkoo - "Everything But You (Remix)" ft. Backroad Gee & Young Chencs
COLLAR - "Gotta Go!"
Dayme y El High, Brray & Tito "El Bambino" - "No te quites" ft. Rayvanny
DJ Nelson & Ferro - "Santa"
Don Patricio - "El Pueblo en la Casa"
FKJ - "Way Out"
Fuego, R3HAB & Duki - "Una Vaina Loca R3hab Remix" ft. Manuel Turizo
GIVĒON - "Lie Again"
Grace Kinstler - "Breaking Myself"
Guapdad 4000 - "Black Iverson"
Harlee - "Reset"
Holly Humberstone - "Sleep Tight"
IDK - "Dog Food" ft. Denzel Curry
Internet Money & Yeat - "No Handoutz"
Jake Owen - "1X1"
Jenny69, Dj Morphius & Muzik Junkies - "Buchona Vibez"
Jnr Choi - "TO THE MOON (Remix)" ft. M24, Russ Millions, G Herbo & Fivio Foreign
Jodosky & Auudi - "No Fumaba"
JonLee - "Pensando en Ti"
Justin Bieber - "Honest" ft. Don Toliver
KA$HDAMI - "Phoenix"
Kaash Paige - "Girlfriend"
Khalid - "Skyline"
KREAM & Jake Tarry - "Once Again"
La Perversa & Lírico En La Casa - "Esa Flaca"
LAGOS - "Tengamos Pasado"
Leroy Sanchez - "Por Siempre Jamás"
Lil Baby - "Frozen"
Lil Gnar - "No Switches" ft. Tory Lanez
Lil Gotit - "Rich Shit" ft. Ty Dolla $ign & Lil Keed
Lil Mexico & Lil Durk - "Can't Lose"
Lil Tjay - "Goin Up"
Lindsay Ell - "Right On Time"
Maddie Poppe - "One That Got Away"
Maggie Lindemann - "how could you do this to me" ft. Kellin Quinn
Manast LL' - FWTS feat. THE VENICE
Manu Manzo & LATENIGHTJIGGY - "Sensualidad"
Marco Mares - "Match"
Marshmello & Tokischa - "ESTILAZO"
MAX - "Gucci Bag"
Miya Folick - "Oh God"
Nardo Wick - "Krazy Krazy"
Ola Runt - "Teardrop"
Oriana - "325"
Pablo Pesadilla, Cris Mj & Harry Nach - "Baby Doll"
Pedro Capó - "La Fiesta"
Reykon - "Bandidos"
RIVAS - "EVA"
Sasha Keable & Jorja Smith - "Killing Me (acoustic)"
Scorey - "Oh, Oh"
Sharlene - "20 Minutos"
Softest Hard - "La Luz" ft. Kali Uchis
SpotEmGottem - "Creep When I Step"
Steve Aoki & HRVY - "Save Me"
The Stupendium - "The Toybox"
T-Pain - "That’s Just Tips"
The Hertz - "人 (Mankind)"
Tink & 2 Chainz - "Cater"
Tom Walker - "Serotonin"
Tommy Royale - "Gitana"
UMI - "whatever u like"
Unlike Pluto - "Against the Timeline"
West Blanco & Noreh - "San Andrés"
YoGambii - "Fuego"
YSN Flow - "Hotbox"
Yung Boi - "Reality"
4/30
​gizmo - "At The Beach"
Lena Mædgen - "Quit."
姜濤 (Keung To) - "作品的説話 (What the Work Says)"
​SSGKobe - "NO L'S"
Tory Lanez - "London (

For October 2021 singles releases, visit this page

This page highlights the notable albums, EPs, mixtapes, etc, released in all genres… Read More 10/1
Andy Mineo - Never Land II - 14/14
Asking Alexandria - See What's on the Inside - 11/11
Asleep at the Wheel - Half a Hundred Years - 3/19
Ballout - Red Eye Music - 21/21
Bear1Boss - It's Easy - 4/26
Booka600 - LOYAL - 13/15
Brandi Carlile - In These Silent Days - 10/10
Client Liaison - Divine Intervention - 14/14
Dar Williams - I'll Meet You Here - 10/10
DontSleep & Meezy SG - Wake Up! - 0/12
Dying Wish - Fragments of a Bitter Memory - 11/11
Felix Jaehn - BREATHE - 15/15
FinaoThaDon - Rebirth - 1/8
Hans Zimmer - No Time to Die (Original Motion Picture Soundtrack) - 21/21
Headie One - Too Loyal for My Own Good - 12/13
illuminati hotties - Let Me Do One More - 12/12
Jeremy Zucker - CRUSHER - 12/12
JoJo - trying not to think about it - 12/12
Leah Kate - What Just Happened? - EP - 7/7
Like Mike - Pain, Love, & What Comes After - 4/15
Lil Wayne & Rich the Kid - Trust Fund Babies - 10/10
Lily Rose - Stronger Than I Am - 7/7
Logan Mize - Welcome to Prairieville - 1/11
Lonr. - Land of Nothing Real 2 - 8/8
LVCRFT - The Return - 10/13
Mat Kearney - January Flower (Deluxe) - 16/16
Meek Mill - Expensive Pain - 18/18
Ministry - Moral Hygiene - 10/10
Mink Slide - Funk on Wheels - 2/10
Molly Payton - Slack - 4/8
Newsboys - Stand - 10/10
Noodah05 -  Reborn - 7/13
Pia Mia - My Side - 5/5
Pond - 9 - 9/9
Potter Payper - Thanks for Waiting - 18/18
RAY BLK - Access Denied - 14/14
Ryan Trey - A 64 East Saga - 14/14
Strand of Oaks - In Heaven - 11/11
Sugababes - One Touch (20 Year Anniversary Edition) - 41/41
The Doobie Brothers - Liberté - 12/12
The Script - Tales From The Script: Greatest Hits - 18/18
Thouxanbanfauni - TTB: STREETS CHOSE ME - 14/15
Tirzah - Colourgrade - 10/10
Tony Bennett & Lady Gaga - Love for Sale - 12/12
TWICE - The Feels - EP - 6/6
Valley - Last Birthday - 7/7
Various Artists - The Daptone Super Soul Revue (Live at the Apollo) - 0/32
Wage War - Manic - 11/11
Wiki - Half God - 16/16
Ycee - Love Drunk - 7/7
Yes - The Quest - 11/11
10/4
Lute - Gold Mouf - 13/13
10/5
aespa - Savage - 6/6
Golden Child - DDARA - 13/13
WOODZ - ONLY LOVERS LEFT - 6/6
Youngjae - COLORS from Ars - 7/7
10/6
Alex Porat - MISS SICK WORLD - 9/9
Big Thief - Change - EP - 4/4
BLITZERS - SEAT-BELT - 6/6
glaive & ericdoa - then i'll be happy - 8/8
GLAY - FREEDOM ONLY - 5/12
iLoveMakonnen - DMW007 - 10/23
Rayne Johnson - Love Drunk or Lonely - EP - 6/6
SPiCYSOL - From the C - 10/10
10/7
Julia Wolf - Girls in Purgatory - 8/8
PIXY - TEMPTATION - 9/9
Shad da God - In God We Trust - 5/15
10/8
AJ Mitchell - SKYVIEW - 12/12
Anita Wilson - Soul Sister - 10/10
Anna Leone - I've Felt All These Things - 10/10
Atmosphere - WORD? - 14/14
BADBADNOTGOOD - Talk Memory - 8/8
Blake Rose - A World Gone By - 7/7
bbno$ - eat ya veggies - 12/12
Cody Johnson - Human: The Double Album - 18/18
Curren$y - Still Stoned on Ocean - 11/11
Donna Summer - I'm a Rainbow: Recovered & Recoloured - 1/15
Don Toliver - Life of a DON - 16/16
Elderbrook - Innerlight - EP - 4/4
Far Caspian - Ways to Get Out - 11/13
Flee Lord & Roc Marciano - Delgado (Deluxe) - 15/15
Gia Woods - Heartbreak County - 4/4
James Blake - Friends That Break Your Heart  - 12/12
Jesse McCartney - New Stage - 10/10
Joel Corry & Jax Jones - OUT OUT (The Remixes, Pt. 1) - 0/4
Joel Corry & Jax Jones - OUT OUT (The Remixes, Pt. 2) - 1/3
Josh Turner - King Size Manger - 3/11
Justin Bieber - Justice (Complete Edition) - 25/25
KESHORE - Sunset Diary - 3/9
Kidd Keo - Rockport Espacial 2 - EP - 6/6
Ladyhawke - Time Flies - 10/11
Lil Revive - Grim Peaks III - 7/7
Madonna - Madame X - Music from the Theater Xperience (Live) - 20/20
Magdalena Bay - Mercurial World - 14/14
Marc E. Bassy - Little Men - 15/15
Moaning Lisa - Something Like This But Not This - 12/12
Natalie Hemby - Pins and Needles - 5/11
Oh Wonder - 22 Break - 11/11
Old Dominion - Time, Tequila & Therapy - 13/13
osquinn - i'm definitely getting sued for this (beat tape no.1) - 4/4
Pip Blom - Welcome Break - 11/11
POORSTACY - Party at the Cemetery - 14/14
Porches - All Day Gentle Hold! - 11/11
Powfu - tell me your feelings and i won't tell you mine - 5/5
Reba McEntire - Revived Remixed Revisited - 30/30
RINI - Constellations - 12/12
Sam Fender - Seventeen Going Under - 11/11
Sleepy Hallow - Still Sleep? (Deluxe) - 25/25
Sumo Cyco - Initiation (Deluxe) - 15/15
Tech N9ne - ASIN9NE - 18/18
The Alchemist - This Thing of Ours, Vol. 2 - EP - 5/5
The Breathing Process - Labyrinthian - 10/10
The Record Company - Play Loud - 4/12
The Warning - MAYDAY - 6/6
The Wild Feathers - Alvarado - 12/12
Trivium - In the Court of the Dragon - 10/10
UPSAHL - Lady Jesus - 10/10
Vanilla Ninja - Encore - 14/18
Various Artists - Broken Hearts & Dirty Windows: Songs of John Prine, Vol. 2 - 5/12
We Are Scientists - Huffy - 10/10
10/11
James Blake - Friends That Break Your Heart (Bonus) - 13/13
10/12
ENHYPEN - DIMENSION: DILEMMA - 8/8
MAJ - No One Cares 2 - 10/10
Smile Empty Soul - Black Pilled - 11/11
TRI.BE - VENI VIDI VINCI - 7/7
10/13
BIGBABYGUCCI - Human - 20/20
Duwap Kaine - HardHead - 11/11
GRACEY - Fragile - EP - 4/4
Slimelife Shawty - Better Living - 14/14
Voda Fuji - Tourist - EP - 6/6
Yogee New Waves - WINDORGAN - 0/12
ちゃんみな (CHANMINA) - ハレンチ (Harenchi) - 16/16
10/14
LightSkinKeisha - Break the Bank - 8/8
Lovejoy - Pebble Brain - 7/7
Mar90s - Pray 4 Me 2 - 13/13
midwxst - wxstnbv2 - 12/12
Norah Jones - I Dream of Christmas - 13/13
10/15
Aaron Cole - Two Up Two Down - 14/14
Anson Seabra - Feeling for My Life - 9/9
Avenue Beat - ​the debut farewell album  - 12/12
Baker Boy - Gela - 13/14
BLACKSTARKIDS - Puppies Forever - 12/12
BONES & cat soup - ForbiddenImage - 13/13
Cassadee Pope - Thrive - 13/13
Charlotte OC - Here Comes Trouble - 12/12
Cheat Codes - HELLRAISERS, Part 2 - 13/13
Chelsea Cutler - When I Close My Eyes - 13/13
City Morgue - CITY MORGUE VOL 3: BOTTOM OF THE BARREL - 13/13
Coldplay - Music of the Spheres - 12/12
Coldplay - Music of the Spheres (Japan Exclusive) - 14/14
Dax - Pain Paints Paintings - 16/16
DOM KENNEDY - From the Westside with Love 3 - 15/15
Ego Ella May - FIELDNOTES - EP - 4/4
Ellise - Letting the Wolf In - 8/8
FINNEAS - Optimist - 13/13
Gemini Syndrome - 3rd Degree (The Raising) - 13/13
George Cosby - We Stand Alone - EP - 5/5
Grafh & DJ Shay - Stop Calling Art Content - 1/13
Gucci Mane - So Icy Boyz - 15/17
Hayden Thorpe - Moondust for My Diamond - 12/12
ICE NINE KILLS - Welcome to Horrorwood: The Silver Scream 2 - 14/14
Jazmine Flowers - adulting - EP - 5/5
JESSIA - How Are You? - EP - 6/6
John Carpenter, Cody Carpenter & Daniel Davies - Halloween Kills (Original Motion Picture Soundtrack) - 20/20
Joy Crookes - Skin - 13/13
JP Cooper - She - 12/24
Kacy Hill - Simple, Sweet and Smiling - 11/11
Karen Harding - Sweet Vibrations - EP - 8/8
Kelly Clarkson - When Christmas Comes Around... - 15/15
KIRBY - Sis, He Wasn't the One - EP - 10/10
Lutharo - Hiraeth - 10/10
Last Days of Eden - Butterflies - 9/14
Loski - Censored - 10/10
Louis the Child - Euphoria - EP - 6/6
Mac Miller - Faces (Re-Release) - 25/25
Mac Powell - New Creation - 6/10
Michelle Branch - The Spirit Room (20th Anniversary Edition) - 13/13
Myra - Bokser & Ballerina - 12/12
Offset Jim - Rich Off the Pack - 6/9
Payroll Giovanni - Giovanni’s Way - 3/18
PinkPantheress - to hell with it - 10/10
Purple Disco Machine - Exotica - 14/14
Qveen Herby - HALLOQVEEN - EP - 7/7
Remi Wolf - Juno - 13/13
Ryan Hurd - Pelago - 15/15
Santana - Blessings and Miracles - 10/15
Skillibeng - Crocodile Teeth - 3/12
The Agonist - Days Before the World Wept - EP - 5/5
The Beatles - Let It Be (Super Deluxe) - 41/57
Toby Keith - Peso in My Pocket - 10/10
Tom Morello - The Atlas Underground Fire - 12/12
Tone Stith - Still FWM - 7/7
Twelve Foot Ninja - Vengeance - 10/10
Various Artists - Pokémon 25: The Album - 14/14
We Are Messengers - Wholehearted - 12/12
Welcome Records - Little Comp of Horrors, Vol. 3 - 1/13
Wilderado - Wilderado - 10/10
wolfacejoeyy - home - EP - 6/6
Young Thug - Punk - 20/20
Zac Brown Band - The Comeback - 15/15
Zack Fox - shut the fuck up talking to me - 9/9
Tiësto - Together Again - 6/6
10/18
LEE JINHYUK - Ctrl+V - 6/6
Maxo Kream - WEIGHT OF THE WORLD - 16/16
TisaKorean - pResiLLy - 0/9
10/19
Matt Citron - New World Disorder - 1/5
Nam Woo Hyun - With - 6/6
10/20
CL - ALPHA - 11/11
CNBLUE - WANTED - 5/5
Nami - DEMOS FOR DRAKE - 6/6
TyFontaine - Ascension (Deluxe) / Virtual World 2 - 25/25
10/21
IGNEA and ERSEDU - BESTIA - 6/6
KINGDOM - History of Kingdom: Part III. Ivan - 7/7
Moonroof - Dream State - 7/7
RÜFÜS DU SOL - Surrender - 11/11
TisaKorean - mr.siLLyfLow - 5/13
10/22
347aidan - CHASING HARMONY - 5/5
Agnes - Magic Still Exists - 11/11
BIA - FOR CERTAIN (Deluxe) - 14/14
Biffy Clyro - The Myth of the Happily Ever After - 11/11
Big Zuu - Navigate - 6/12
BKTHERULA - LOVE BLACK - 16/16
Brett Eldredge - Mr. Christmas - 11/11
Catalyst Crime - Catalyst Crime - 10/12
Circa Survive - A Dream About Love - EP - 6/6
Comethazine - Comethazine The Album - 18/18
Cradle of Filth - Existence is Futile - 14/14
Creed Fisher - Whiskey and the Dog - 3/14
Culture Jam - Kawhi Leonard Presents: Culture Jam (Vol. 1) - 7/7
Demarco - Melody - 12/16
Dillon Carmichael - Son Of A - 6/14
Don Broco - Amazing Things - 12/12
Don Q - Double or Nothing - 2/10
Dream Theater - A View from the Top of the World - 7/7
Dua Saleh - CROSSOVER - EP - 7/7
Duran Duran - FUTURE PAST - 12/12
DVBBS - SLEEP - 15/15
elijah​ woods - Look What I Made - EP​ - 6/6
Elton John - The Lockdown Sessions - 16/16
Every Time I Die - Radical - 16/16
Felly - Young Fel 2 - 14/14
Fetty Wap - The Butterfly Effect - 17/17
​flora cash - Our Generation - 14/14
Fuel - ÅNOMÅLY - 5/11
Gabrielle - KLIPP MEG I TI OG LIM MEG SAMMEN - 12/12
GIRLI - Damsel in Distress - EP - 5/5
Helado Negro - Far In - 14/15
Hey Violet - Deep End - EP - 3/3
HONNE - LET'S JUST SAY THE WORLD ENDED A WEEK FROM NOW, WHAT WOULD YOU DO? - 11/11
Hunter Hayes - Wild Blue (Complete) - 13/16
ILLENIUM - Fallen Embers (Deluxe) - 19/19
James Ivy - Good Grief! - 5/5
Jessie James Decker - The Woman I've Become - 7/7
JPEGMAFIA - LP! - 18/18
JPEGMAFIA - LP! (OFFLINE) - 20/20
Lady A - What a Song Can Do - 14/14
Lana Del Rey - Blue Banisters - 15/15
Lil Wop - Zero Gravity - 3/5
Luh Soldier & Zaytoven - Keys To the Streets - 8/10
Majid Jordan - Wildest Dreams - 11/11
Mazey Haze - Always Dancing - EP - 5/5
Mimi Webb - Seven Shades of Heartbreak - 7/7
Moneybagg Yo - A Gangsta's Pain (Reloaded) - 29/29
Moyka - The Revelations of Love - 10/10
My Morning Jacket - My Morning Jacket - 11/11
NorthSideBenji - The Extravagant Collection - 13/13
Okay Kaya - The Incompatible Okay Kaya - 9/9
Oscar and the Wolf - The Shimmer - 11/11
Paris Shadows - Two Nights In Paris - 12/12
Parquet Courts - Sympathy for Life - 11/11
Pouya - Blood Was Never Thick as Water - 11/11
Read Southall Band - For the Birds - 10/12
Ritt Momney - Sunny Boy - 11/11
Rob Thomas - Something About Christmas Time - 10/10
ROSIE - 20mg of Happiness - 7/7
SASSY 009 - Heart Ego - 4/8
Self Esteem - Prioritise Pleasure - 13/13
SEVENTEEN - Attacca - 7/7
Starjunk 95 - Plastic Memories - 2/4
STARSET - HORIZONS - 16/16
Surf - Archangel - 13/13
Tenille Arts - Girl to Girl - 13/13
The Orion Experience - Fever Dream - 8/8
Wale - Folarin II - 15/15
Wet - Letter Blue - 10/10
Big Baby Tape & kizaru — BANDANA I — 14/14
10/23
Lulu Bitto - GAME OVER と生まれ変わる (Game over to Umare Kawaru) - 3/3
10/24
Lil Boom - end. END. end. (the collection) - 6/6
10/25
Lil Tra$h - Meme King - 11/11
NCT 127 - Favorite - 14/14
10/26
DreamNote - Dreams Alive - 4/4
EPEX - BIPOLAR Pt.2 : 사라의 서: Prelude of Love - 4/4
First of October - Gotta Record Everything Good - 11/11
Joey Trap - ALIEN - 10/10
10/27
AILEE - AMY - 12/12
Jordan Hawkins - Heart Won’t Stop - 7/7
LOONA - Not Friends Special Edition - 5/5
SahBabii - Do It for Demon - 20/20
Various Artists - 스트릿 우먼 파이터 (Street Woman Fighter) Special - 4/4
10/28
bosco herrero - destino / saturno - 7/7
BLOO - MOON AND BACK - 8/8
Buju - Sorry I'm Late - 7/7
CusaX - Violent Poetry - 15/15
DC2Trill - Drank Babies 3 - 3/12
Kassy - 옛이야기 (Old story) - 4/4
Namasenda - Unlimited Ammo - 13/13
PARK JI HOON - HOT&COLD - 6/6
10/29
A$AP Rocky - LIVE.LOVE.A$AP (Re-Release) - 15/15
Ad Infinitum - Chapter II (Legacy) - 15/15
Alina Baraz - Moongate - EP - 4/4
Amaal - Milly - 7/7
Archspire - Bleed the Future - 8/8
Augustine - Weeks Above the Earth - 11/11
AViVA - VOLUME II - 11/11
BabyTron - Bin Reaper 2 - 27/27
Bad Wolves - Dear Monsters - 12/12
Be'lakor - Coherence - 8/8
Beast in Black - Dark Connection - 13/13
Big Sean & Hit-Boy - What You Expect - EP - 6/6
Black Veil Brides - The Phantom Tomorrow - 12/12
CHVRCHES - Screen Violence: Director’s Cut - 13/13
​cktrl - ​zero - EP - 3/4
Curren$y & Harry Fraud - Regatta - 7/8
Dami Im - MY REALITY - 10/10
Dead or Alive - Fan the Flame, Pt. 2 (The Resurrection) - 10/20
DJ Abilities - Phonograph Phoenix - 1/8
Doodie Lo - Big Doodie Lo (Deluxe) - 16/21
Ed Sheeran - = - 14/14
Ekhoe - Osztálykép - 12/12
Emily Scott Robinson - American Siren - 10/10
Geese - Projector - 9/9
Ghostface Killah - Ironman (25th Anniversary) - 17/17
Hayes Carll - You Get It All - 11/11
IDK - USEE4YOURSELF (Deluxe) - 26/26
JEON SOMI - XOXO - 8/8
Jerry Cantrell - Brighten - 9/9
Joe Bonamassa - Time Clocks - 10/10
John 5 & the Creatures - Sinner - 0/10
Johnny Cash - Bear's Sonic Journals: Live at the Carousel Ballroom, 4/24/1968 - 28/28
Joni Mitchell - Joni Mitchell Archives, Vol. 2: The Reprise Years (1968-1971) - 0/119
Katy B - Peace and Offerings - 8/8
Kevin Ross - Drive 2 - 2/10
Kxllswxtch - DISORDER - 12/12
Lily Rose - Stronger Than I Am (Repack) - 10/10
Luke Wild - Shoebox - EP - 5/6
Mastodon - Hushed and Grim - 15/15
Maude Latour - Strangers Forever - EP - 6/6
Maximillian - Too Young - 7/11
Megan Thee Stallion - Something for Thee Hotties - 21/21
Meghan Trainor - A Very Trainor Christmas (Deluxe) - 21/21
Mick Jenkins - Elephant in the Room - 12/12
Mon Laferte - 1940 Carmen - 10/10
Morgan Evans - The Country and the Coast, Side A - EP - 3/6
NICKI NICOLE - Parte de Mí - 16/16
Of Monsters and Men - My Head is an Animal (10th Anniversary Edition) - 14/14
Ola Runt - Henchmen Crime Family: Life of Sin - 1/13
Plush - Plush - 13/13
Pentatonix - Evergreen - 14/14
Pixey - Sunshine State - EP - 6/6
R.E.M. - New Adventures in Hi-Fi  - 19/27
Ransom & Rome Streetz - Coup De Grâce - 11/11
REASON - No More, No Less: Demo 1 - 3/3
ROMderful - PLEASE RECONNECT CONTROLLER - 0/15
scarlxrd - DeadRising - 21/21
Sematary - Screaming Forest - 10/10
TheCrewDown - ChanceLOR - 0/11
The War on Drugs - I Don't Live Here Anymore - 10/10
Tom Gregory - Things I Can't Say Out Loud - 12/12
Tori Amos - Ocean to Ocean - 11/11
UnoTheActivist - Unoverse 3 - 14/14
Various Artists - The Harder They Fall (Original Motion Picture Soundtrack) - 14/14
War of Ages - Rhema - EP - 4/4
Whitechapel - Kin - 11/11
Wolf Alice - Blue Weekend (Tour Deluxe) - 16/16
10/30
Sniper Gang - Sniper Gang Presents: Nightmare Babies - 11/11
10/31
Bryson Tiller - Killer Instinct 2: The Nightmare Before - 13/13
CHXPO - HALLOWEEN KING - 2/11
Guap Tarantino - Shudup Recharged - 0/10
Limp Bizkit - Still Sucks - 

Oooooooooh
I wanna be wherever you are, baby
Oooooooooh
Impossible to take it too far

Summer nights, gettin' high like the first time
You and I, make it last forever
Summer nights, gettin' high like the first time
You and I, make it last forever
You and I, make it last forever
Make it last forever

I see you in my bed
Gettin' undressed
It's about to go down, baby
It wasn't just a dream
I guess it's meant to be
I got to tell you right now, baby
See Tiësto LiveGet tickets as low as $75You might also like
Oooooooooh
I wanna be wherever you are, baby
Oooooooooh
Impossible to take it too far

Summer nights, gettin' high like the first time
You and I, make it last forever
Summer nights, gettin' high like the first time
You and I, make it last forever
You and I, make it last forever
Makin' lust forever, baby
Ooooooh, yeah

Make it last 

For March 2024 album releases, visit this page

This page highlights the notable singles released in all genres throughout March 2024. Each song… Read More 3/1
21 Lil Harold - "Gin & Juice" ft. BigXthaPlug
​4batz - "​act iii: on god? (she like)"
Alkaline - "Feel Like God"
Apel8 - "Givenchy" ft. Lil Skies
Babyface Ray - "Green Carpet"
Becky Hill & Alcemist - "Never Be Alone (Alcemist Remix)"
Benedict Cork - "Nice Guy"
Cardi B - "Like What (Freestyle)"
Carly Pearce - "hummingbird"
Charlotte Lawrence - "I Don't Wanna Dance"
Chlöe - "FYS"
Ella Henderson - "Alibi (Joel Corry Remix)" ft. Rudimental
Empress Of - "Preciosa"
Faouzia - "Fur Elise"
FCG Heem - "Lil Boosie"
FLETCHER - "Doing Better"
Forest Blakk - "You Wеre Mine"
Galantis, David Guetta & 5 Sеconds of Summer - "Lighter"
Genia - "Know!"
Heembeezy - "Murda"
Honey Bxby - "Touchin' (Busta Rhymes Remix)" ft. Busta Rhymes
Jesse McCartney - "Make a Baby" ft. Yung Gravy
Jordan Rakei - "Learning"
Jordy - "Wonderkid"
Joyner Lucas & Conway the Machine - "Sticks & Stones"
Keith Urban - "Messed Up As Me"
Kodie Shane - "Letting Go"
Lana Lubany - "STANNA"
Leony - "Simple Life"
Liam Payne - "Teardrops"
Lil Migo - "Hello Kitty"
Lil Xan - "Won't Overdose"
Loreen - "We Will Rave"
Luh Tyler - "Bad Bitch"
Lykke Li - "Ring of Fire"
Mariee Sioux - "Christmas Was Canceled in Bethlehem"
Matt Citron - "Enjoy"
MRG & Rah Swish - "DECLINE"
Nascent & Orion Sun - "Big Brown Eyes"
Nathan Dawe & Bebe Rexha - "Heart Still Beating (Ian Asher Remix)"
Olly Alexander - "Dizzy"
Owl City - "Car Trouble"
Pharrell Williams & Miley Cyrus - "Doctor (Work It Out)"
PxRRY, Jon Vinyl & Tone Stith - "You Don't Call Me"
QUIN - "READi"
North Ave Jax & ​jetsonmade - "Crash"
S9 - "Ben Arfa"
Samara Joy - "Why I'm Here"
Sarina - "Olé"
Scotty McCreery - "Slow Dance"
Shotgun Willy - "Winnebago"
Stephen Dawes - "Want Me"
Surfaces & JVKE - "Don't Let Me Down"
The Kid LAROI - "Still Yours (From The Doc)"
The Veronicas - "Here To Dance (Front Row Remix)"
TWRP - "A Human's Touch" ft. McKenna Rae
YTB Fatt - "Brazzi Blue Cheese"
3/4
Anti Da Menace - "Banned From Da A"
Jackboy - "Styled By Meech"
3/5
New Kids on the Block - "Kids"
Windser - "Desert Song"
3/6
Bar Yahman & Hard Bass School - "Sample Text"
Jelani Aryeh - "Sweater Club"
Laufey - "Goddess"
Lil Zay - "4800"
Luke Hemmings - "Shakes"
Mac Critter - "Binary Triggers"
Victor Ray - "Halfway There"
3/7
Alicia Creti - "Bleeding Me Dry - A COLORS SHOW"
Bronze Avery - "Spring Break"
Fredo Bang - "You Hate Me"
Kian Kova - "Vía"
Mura Masa - "Still"
S Club - "Good Times (Bradley & Jon)"
SONIKKU & Rakky Ripper - "Wonky"
3/8
1010benja - "I Can"
Alexander Stewart - "broken by you"
Allison Ponthier - "Skin"
Angus & Julia Stone - "Cape Forestier"
Babyface Ray - "Money On My Mind"
Becky Hill & Daire - "Never Be Alone (DAIRE Remix)"
Bennett Coast - "Pretender"
Benjamin Ingrosso - "Kite (Acoustic)" ft. Astrid S
Big Homiie G - "Intro"
Bow Anderson - "12 Minute Walk"
Britnee Kellogg - "She's Come a Long Way"
Cae Cartier - "Long Gone"
Chase Shakur - "OPTIONS"
Chase Shakur - "YOLANDA"
Conan Gray - "Alley Rose"
Chris Young - "What She Sees in Me"
d4vd - "My House Is Not A Home"
DJ Premier & Russ - "Work This Out"
Ella Henderson - "Mamma You Were Right"
Fridayy - "Without You"
Jason Derulo & Michael Bublé - "Spicy Margarita (R3HAB Remix)"
Jax Jones, Zoe Wees & Cascada - "Never Be Lonely (Cascada Remix)"
Jean Deaux - "Dreamin"
Jordana Bryant - "How'd You Do It"
KB Mike - "I Want Love"
Koe Wetzel - "Damn Near Normal"
Kuttem Reese - "RAT"
Lekan - "614"
Lil Crix & BLP Kosher - "Kold Shoulder"
Lola Brooke - "Bend It Ova" ft. A Boogie wit da Hoodie & Big Freedia
Marcus King - "Hero"
Mickey Guyton - "Woman"
Noah Davis - "Bfa"
Noodah05 - "Love Songs In Miami"
Pressa - "Get Back Up" ft. Fridayy
Ralan Styles - "Bon Appetite"
Rexx Life Raj - "Couple Months In LA"
Rosa Linn - "Universe"
SCY Jimm - "F.A.N."
Sia & Kylie Minogue - "Dance Alone (Kito Remix)"
Sophie Ellis-Bextor & David Guetta - "Murder On The Dancefloor (David Guetta Remix)"
Sugarhill Dddot - "Outside"
Tank - "Before We Get Started" ft. Fabolous
TBoss - "Pick A Side"
Wizz Havin & L.O.E. Shimmy - "4AM at Coffee Zone" ft. Luh Tyler, BossMan DLow & C Stunna
Tsatsamis - "Faith"
3/9
Ayesha Erotica - "superpuss"
3/11
Andrea Bocelli, Matteo Bocelli & Hans Zimmer - "Time To Say Goodbye"
Dylan Mulvaney - "Days of Girlhood"
3/12
Janie Danger - "Pure Black Tendency"
Tones and I - "I Get High"
Waxahatchee - "365"
WILLOW - "symptom of life"
3/13
Brezden - "Artichoke Dip"
EBK Jaaybo - "Black Bottle Boys"
Lizzy McAlpine - "I Guess"
Mitski - "Buffalo Replaced - Spotify Singles"
Mitski - "Coyote, My Little Brother - Spotify Singles"
PGF Nuk - "ASMR"
3/14
Airospace - "UTOPIA (RING AROUND THE RO$iE)"
BABYMETAL, Bodyslam & F.HERO - "LEAVE IT ALL BEHIND"
Don Toliver - "Deep in the Water"
GANG51E JUNE - "Intersection"
Lil Mabu & Lil RT - "BIG DOG SH*T"
Lucas Estrada, Solar State & Philip Strand - "Diamond"
3/15
42 Dugg - "Wock N Red"
AJ Mitchell - "Flowers on the Moon"
Alice Merton - "​pick me up"
AViVA - "DOC MARTENS"
Babyface Ray - "Understand"
Beautiful Life All Stars, Mary J. Blige & Vado - "Beautiful Life All Stars"
Becky Hill - "Never Be Alone (Extended Mix)"
Becky Hill - "Never Be Alone (Orchestral Acoustic)"
Ben Platt - "Andrew"
Ben Rector & Hailey Whitters - "Color Up My World"
Cardi B - "Enough (Miami)"
Cascada - "Ain't No Mountain High Enough"
Cash Cash & Bryce Vine - "New Madonna"
Chicken P - "Shark"
Connor Price - "Too Bad"
DaBaby - "WONDER WOMAN"
Dabin, Said The Sky & Clara Mae - "In The End"
Dee Gatti - "Unsure"
Dua Lipa - "Training Season (London Sessions)"
Dylan - "The Alibi (Live Piano Version)"
Dylan Conrique - "last one to love me"
EmanuelDaProphet - "VICIOUS CYCLE" ft. Rylo Rodriquez
Gunna - "Prada Dem" ft. Offset
Haiden Henderson - "hell of a good time"
Jennifer Lopez - "This Time Around ((G)I-DLE Remix)" ft. (G)I-DLE
Kenny Chesney - "Wherever You Are Tonight"
Kenya Grace - "It's not fair"
Kris Allen – "Guinevere"
Lilith Max - "Still With Me"
Matt Citron - "Chemicals"
Medium Build - "Knowing U Exist"
Melodia y Rumba - "No Puedo Olvidar"
Neoni - "SUCKER PUNCH"
Nia Archives - "Unfinished Business"
Odeal - "Gaslight 101"
OS NANA - "They Ain't Ready" ft. Matt OX, ​​​​iayze, BEAR1BOSS & Zubin
PARTYNEXTDOOR - "R e a l W o m a n"
Phoebe Green - "I Could Love You"
RaeLynn - "Funny Girl"
Ricky Montgomery - "Unknown Phantom"
Riley Green - "Way Out Here"
Sasha Alex Sloan - "Me Again"
Ski Mask The Slump God - "Shibuya"
Stefflon Don - "Big Fat Machine" ft. Fivio Foreign & Major League DJz
tan feelz - "in 'n out"
Trippie Redd - "LWRW"
Tyler Hubbard - "Vegas"
V - "FRI(END)S"
VEDO - "Spinn On You"
Zach Hood - "how to change a tire"
Zae France - "Better Love"
ZAYN - "What I Am"
Zheani & Buttress - "Spoils of War"
3/18
Bri Steves - "Lonely with You / Back Outside - A Colors Show"
Galantis, David Guetta & 5 Seconds of Summer - "Lighter (Extended Mix)"
3/19
Desire - "Darkside"
IC3PEAK - "Жадина (Coromorant)"
Two Shell & FKA Twigs - "Talk to Me"
3/20
AURORA - "Some Type of Skin"
BiC Fizzle - "older times"
griffin tomaino - "heart"
Honey Gentry - "Mykonos"
​koi - "sign in everything"
R3 Da Chilliman - "Been Had It"
3/21
Anitta, Brray & Bad Gyal - "Double Team"
BlueBucksClan, Hit-Boy & Wiz Khalifa - "Made For the Pole"
Broadcast - "Follow the Light"
Broadcast - "Tears in the Typing Pool (Demo)"
Danny Ocean - "Cero condiciones"
IShowSpeed - "Monkey" ft. DJ Luana
Khary - "My Body's My Coffin"
Mac Critter - "Out"
Peso Pluma, Tito Double P & Joel De La P - "LA PEOPLE II"
RIMON - "Flowers"
Russ Millions - "Love Language" ft. Buni & TeeRowdy\
Sara Evans - "Pride"
Saxkboy KD - "Saxk Shit"
Xavi - "Corazón De Piedra"
3/22
Aaron Cole - "Proof"
Alec Benjamin - "King Size Bed"
Alicia Keys - "Kaleidoscope"
Alok & Bebe Rexha - "Deep In Your Love (Dimitri Vegas & Like Mike, Ben Nicky & Dr Phunk Remix)"
Amanda Reifer - "Bitch Like Me (Intro)"
Amaria - "Beggin'"
Armin van Buuren & Gryffin - "What Took You So Long"
Babyface Ray - "Shy Kid"
Benjamin Ingrosso & Olly Alexander - "Kite (Remix)"
Benson Boone - "Slow It Down"
BIG30 - "Nless"
Big Sean - "Precision"
bôa - "Walk With Me"
Cassadee Pope - "Eye Contact"
Cel NoLackin - "Pour A Cup"
Charli XCX - "The von dutch remix with addison rae and a.g. cook"
CHASE WRIGHT - "Tonight I Wanna Cry"
Chris McClarney - "Empty"
ClockClock - "Love U Again"
Darin - "Electric"
Daughtry - "Pieces"
Dua Lipa - "Training Season (Acoustic Version)"
David Bowie - "Ziggy Stardust (Demo)"
Ella Langley - "nicotine"
Elliot Greer - "Gold"
Finesse2Tymes - "Thought It Was Over"
Forest Claudette - "Gold"
Galantis, 5 Seconds of Summer & Misha K - "Lighter (Galantis & Misha K VIP Mix)" ft. David Guetta
girl in red & Sabrina Carpenter - "You Need Me Now?"
Heembeezy - "Mike Phelps"
IShowSpeed - "Amar De" ft. MC Kevin O Chris
JJ Wilde - "Best of Me"
Jordyn Shellhart - "Search My Name" ft. Donovan Woods
Kane Brown - "Fiddle in the Band"
Kash Doll & Tee Grizzley - "Pressin'"
Kerli - "Search + Destroy"
Khalia - "Taboo"
Kygo & Ava Max - "Whatever (Tiësto Remix)"
Lady Kabela - "A.W.N.F. / Flies"
Lil Bean - "​beautiful (baby jaycee)"
Lily Rose - "Parking Lot"
Lily Rose - "True North"
Marsha Ambrosius - "One Night Stand"
Matt Nathanson - "map at the mall"
Paperboy Fabe & Pink Sweat$ - "Hundred Million Reasons"
Rublow - "Rappin N Trappin"
Sabrina Sterling - "Bittersweet"
Sam Hunt - "Locked Up"
Seven Lions & ILLENIUM - "Not Even Love" ft. SDÍS
SleazyWorld Go - "WTW"
SLOE JACK - "WAKEY WAKEY"
Troy Cartwright - "How Smart I Am"
UNA MIA & Lekan - "Better Care (Remix)"
Wade Bowen - "Rainin On Me"
Wyatt Flores - "Wish I Could Stay"
YXNG K.A & Saadifour - "Off My Mind"
Zac Brown Band - "Tie Up"
3/23
IShowSpeed - "Get Down"
Sasha Haydn - "Mercury in Marmalade"
3/24
​bbno$ - "lil' freak"
3/25
BossMan Dlow - "Finesse (Remix)" ft. GloRilla
Charlotte Day Wilson - "Canopy"
Flyana Boss - "Money At"
Sinéad Harnett - "Same Rhymes / Burn - A COLORS SHOW"
Yung Bambi - "USH"
3/26
Lil Dann - "WIPED" ft. Lil Yachty
Ronnie Earl & Diamanda Galás - "A Soul That's Been Abused (Live)"
YTB Fatt - "Same"
3/27
Camila Cabello – "I LUV IT" ft. Playboi Carti
Die Antwoord - "Everything Is Perfect"
Don West - "Rather Be Lonely"
ellis - "it’ll be alright"
KATO2X - "I'm Coming"
PGF Nuk - "Baby Death"
Shygirl – "Making The Beast"
3/28
Becky Hill - "Outside Of Love"
Bnny - "Something Blue"
boyband - "tell me i'm perfect"
Connor Price - "Too Bad (Acoustic)"
David Archuleta - "Hell Together"
Dean Lewis - "The Last Bit Of Us"
Lil Darius - "Please"
Lorde - "Take Me to the River"
MoneySign Suede & Sada Baby - "Playground"
Mozzy - "JADED" ft. Eric Bellinger
St. Vincent - "Flea"
twenty one pilots - "Next Semester"
3/29
A Boogie wit da Hoodie - "Steppas"
Alex Warren - "Save You a Seat"
Annie Bosko - "Higher Ground" ft. Vince Gill
Ashley Monroe - "I Like Trains"
Aya Nakamura - "Doggy"
Bizzy - "When It Ends"
Byron Juane & Kenyon Dixon - "Timeless"
Chase Elliott - "​the cycle"
Cheat Codes & Regard - "Stay Another Night"
Daniel Powter - "Bad Day (Stripped Down)"
Desiigner - "Rolls Truck"
Doechii & JT - "Alter Ego"
Doodie Lo - "4 RINGS" ft. BIG30
Dua Lipa - "Training Season (Chloé Caillet Mix)"
Dylan Dunlap - "Will You"
Elle Darlington - "​one more night​"
ERIC NORTH - "Spirit + Heart"
G Herbo - "Subject"
gavn! - "one day you're gone"
Graham Barham & Lauren Watkins - "STRAIGHT TO MY HEART"
Hunter Daily - "California Poppies"
Hurricane Wisdom - "So Gone (Freestyle)"
Isaac Dunbar - "American High"
Jake Miller - “If Heaven Could Share You”
Jessica Baio - "20 something"
Jonathan Roy - "Nice To Meet You"
KALEO - "Lonely Cowboy"
Kodak Black - "Non Believer"
Lauren Presley - "God Complex"
LOKRE - "Body"
MaKenzie - "LIPS"
Maxo Kream - "Talkin In Screw" ft. That Mexican OT
Moneybagg Yo & Rob49 - "Bussin"
​Natalie Jane - "can i see you tonight?"
NEIKED - "The Moves" ft. Muni Long & Nile Rodgers
OhGeesy - "Yacht Master"
Original God - "BDSM PSYCHEDELIC DEATH WARRANT"
Peach Tree Rascals - "Rendezvous"
Prateek Kuhad - "Just Like A Movie"
Quinn XCII - "Pasadena"
Riley Green - "Worst Way"
Ron Suno & Jim Jones - "Brown Bag"
Rosa Linn & Alfa - "Universe (tra Marte e Venere)"
Sadie Jean - "Aisle 6"
Scotty McCreery - "Red Letter Blueprint"
Shenseea - "Die For You"
Trinity Lake - "Needed Love"
Tucker Wetmore - "Wind Up Missin' You"
​viisi - "i left my hometown"
YUNGBLUD - "Abyss"
3/31
Jennifer Jeffries - "You Were a Child"
Song House & KAYKO - "What 

You are my glass half empty
Sipping my ocean dry
Emotionally spin me
'Till none of our planets could align
But I could stand you one more night

I like us better when we're wasted
It makes it easier to say it
Lay all your laundry on the bed
And then I'll lay in it instead
I like us better when we're wasted
Oh woah, woah, woah, woah
See Tiësto LiveGet tickets as low as $75You might also like
You are a catch-22, either way I miss out
All of the grief I give you
Is energy I can live without
But I could stand you one more night

I like us better when we're wasted
It makes it easier to say it
Lay all your laundry on the bed
And then I'll lay in it instead
I like us better when we're wasted
Oh woah, woah, woah, woah

I like us better when we're wasted
It makes it easier to say it
Lay all your laundry on the bed
And then I'll lay in it instead
I like us better when we're wasted
Oh woah, woah, woah, woah
Oh woah, woah, woah, 

Nobody else needs to know
Where we might go
We could just run them red lights
We could just run them red lights
There ain’t no reason to stay
We’ll be light years away
We could just run them red lights
We could just run them red lights
We could just run them red lights

White lights, flirt in the darkness
This road leads where your heart is
These signs, something we can’t ignore
We can’t back down
We’ll never let them change us
We’re going to make it now
What are we waiting for...
What are we waiting for...
See Tiësto LiveGet tickets as low as $75You might also like
Nobody else needs to know
Where we might go
We could just run them red lights
We could just run them red lights
There ain’t no reason to stay
We’ll be light years away
We could just run them red lights
We could just run them red lights
We could just run them red lights
We could just run them red lights
We could just run them red lights
We could just run them red 